50 50
|- - - - - - - - - - - - - - @ - - - - - - @ - - - - - - - - - - - - - - - @ - - - - - - - - - - - -|
|- - - - - - - - - - - - - - @ - - - - - - @ - - - - - - - - - - - @ - @ @ @ - - - - - - - - - - - -|
|- - - - - - - - @ @ - - - - - - - - - - - @ - - @ @ - - - - - - - @ - - - - - - - - - - - - - - - -|
|- - - - - - - - @ @ - - - - - - - - - - - - - - @ @ - - - - - - - @ - - - - - - - - - - - - - - - -|
|- - - - - - - @ @ @ @ @ @ - - - @ @ @ - - - - - - - - @ - - - - - - - - - - - - - - - - - - - - @ @|
|- - - - - - - - - - - @ @ @ - - - - - - - - - - - - - @ - - - - - - - - - - - - - - - - - - - - @ @|
|- - - - - - - - - - - - - - - - - - - - - - - - @ @ @ @ - - @ @ @ - - - - @ @ @ - - - - - - - - - -|
|- - - - - - - @ @ - - - - - - - - - - - - - - - - - - - - - @ - @ - @ @ - - - - - @ @ - - - - - - -|
|- @ - - - - - @ @ @ @ @ - - - - - - - - - - - - - - - - - - @ - @ - @ @ - - - - - @ @ - - - - - - -|
|- @ @ @ - - - - - - - - - - - - - - - - - - - - - - - - - - @ @ @ - - - - - @ @ - - - - - - - - - -|
|- @ - - - - - - - - - - - - - - - - - - - - - - - - - - - - - @ @ - - - - @ @ @ - - - - - - - - - -|
|- - - - - - @ @ @ - - - - - - - @ - @ @ @ @ - - @ @ @ - - - @ @ @ - - - - @ - - - - - - - - @ @ - -|
|- - - - - - - - - - - - - @ @ - @ - - - - @ @ - - - @ @ @ - - - - - - - - @ - - - - - - - - @ @ - -|
|- - - - - - - - - - - - - @ @ @ @ @ - - - @ @ - - - - @ @ - - @ @ @ - - - - - - - @ @ @ @ @ @ - - -|
|- - - - - - - - - - - - @ @ @ - - @ @ - - - - - - - - @ @ - - - - - - - - - - - - @ @ - @ - - - - -|
|- - - - - - - @ - - - - @ @ @ @ @ @ @ - - - - - - - - @ @ @ - - - @ - - @ - @ - - @ @ @ @ - - - - -|
|@ @ - - - - - @ - - - - @ @ @ @ @ - - - - - - - @ @ @ @ @ @ - @ @ @ - - @ - @ - - - @ @ - - - - - -|
|- - - - - - - @ - - - - @ - - @ @ - - - - - - - - - @ - - - - - - @ @ - @ - @ - - - @ @ - - - @ @ -|
|- - - - - - - - - - - - @ - - - - - - - - - - - - - @ - - - - - - @ @ - - - - - - - - - - - - @ @ -|
|- - @ @ - @ - - - - - - - - - @ - - - - - - - - - - @ - - @ @ - - - - - - - - - - - - - - - - @ @ -|
|- - @ @ - @ - - @ @ @ - - @ @ @ - - - - - - - - - - - - - @ @ - - @ - - - - - - - - - - - - - - - -|
|- - - - - @ @ @ @ @ - - - @ @ @ - - - - - - - - - @ - - - @ @ - - @ - - - - - - - - - - - - - - - -|
|- - - - - - - - - @ - - - - - - - - - @ @ - - - - @ - - - @ @ - - @ - - - - - @ - - - - - - - - @ -|
|- - - - - - - - - - - - - - - - - - - @ @ @ - @ @ @ - - - - - - - - - - - - - @ - - - - - - - - @ -|
|- - - - @ @ - - - - - - - - - @ @ - - @ @ - - - - - - - - - - - - - - - - - @ @ - - - - - - - - @ @|
|@ - - - @ @ - - - - - - - - - @ @ - - @ @ - - - - - - @ @ @ @ - - - - - - - @ - - - - - - - - - - @|
|@ @ @ - - - - @ - - @ @ @ - @ @ - - - - - - - - - @ @ @ @ - - - - - - - - - @ @ @ @ @ @ @ @ - - - @|
|@ @ @ - @ - - @ - - @ - - - @ - - - - - - - - - - - - - @ - - - - - - - - - - - @ @ @ - - - - - - @|
|- - @ @ @ - - @ - - @ - - - @ - - - - - - - @ - - - - - @ - - - - - - - @ @ @ @ @ - - - - - - - - -|
|- - @ @ @ - - - - - @ - - - - - - - - - - - @ - @ @ @ - - - - - - - - - @ @ @ @ @ - - - - - - - - -|
|- - @ - - - - - @ - - - @ @ @ - - - - - - - @ - - - - - - - - - - - - - - - - - @ - - - - - - - @ @|
|- - - - - - - - @ - - - - - @ @ @ - - - @ @ @ - - - - - - - - - - - - - - - @ @ @ - - - - - - - - @|
|- - - - - - - @ @ - - - - - - @ @ @ @ @ @ @ - - - - - - - - - - - - - - - - - - - - - - - - - - - @|
|- - - - - - - @ - - - - - - - - - - - - - - - - - - - - @ - - - - - @ @ - - - - - - - - - - - - - @|
|- - - - - - - @ - - - - - - - - - - - - - - - - - - - - @ - @ @ @ - @ @ - - - - - - - - @ @ @ - - @|
|- - - - - - - @ @ - - - - @ @ @ @ - - - - - - - - - - - @ - @ - @ - - - - - - - - - - - - @ @ - - -|
|- - - - - - - @ @ @ - - - - - @ @ - @ @ - - - - - - - - - - @ - @ - - - - - - - - - - - - @ @ - - -|
|- - - - - @ - - - - - - - - - - - - @ @ - - - - - - - - - - - - - - - - - - - - - - - - - - - - - -|
|- - - - - @ - - - - - - - - - - - - - - - - @ - - - - - - - - - - @ @ - - - @ @ - - - - - - - - - -|
|- - - - - @ - - - - - - - - - - - - - - - - @ - - - - - - - - - - @ @ - - - @ @ - - - - - - - @ @ -|
|- - - - @ @ - - - - - - - - - - - - - - - - @ - - - - - - - - @ @ @ - - - - - - - - - - - - - @ @ -|
|- - - - @ @ - - - - - - - - - @ @ - - - - - - - - - @ - - - - @ @ - - - - - - - - - - - - - - - - -|
|- - - - - - - - - - - - - - - @ @ - - - - - - - - - @ - - - - - @ @ - - - - - - - - - - - - - - - -|
|- - - - - - - - - - - - - - - - - - - - - - - - - - @ - - - - - @ @ @ @ - - - @ @ @ - - - - - - - -|
|- - - - - - - - - - - - - - - - - - - - - - - - - - - - - - - - - - - - - - - - - - - - - - - - - -|
|- - - - - - - - - - - - - - - @ @ - - - - @ @ - - @ @ - - - - - - - - - - - - - @ - - - - - - - - -|
|- - - - - - - @ @ @ @ - - - - @ @ - - - - @ @ - - @ @ - - - - - - - - - - - - - @ - @ - - - - - - -|
|- - - - - - - - - - @ @ - - - - - - - - - @ - - - @ @ @ - - - - - @ @ @ - - - - @ - @ - - - - - @ @|
|- - - - - - - - - - @ @ - - - @ @ - - - - @ - - - - - @ - - - - - - @ @ @ - - - - - @ - - - - - - -|
|- - - @ @ - - - - - @ @ - - - @ @ - - - - - - - - - - @ @ @ @ - - - @ - @ @ @ - @ @ @ - - - - @ @ @|
