100 20
|@ @ @ - - - - - - - - - - - @ @ @ - - - - - - - - - - - - - - - - - @ - @ @ - - - - - - - - - - - - - - - - - - @ @ @ @ - - - - - - - @ @ - @ @ - - - - @ @ @ - - - - @ - - - - - - @ @ @ - - - @ - - -|
|- - @ - - - - - - - - - - - - - - - - - - - - - - - - - - - - - - - @ - @ @ - - - - - - - - - - - - - - - - @ - - - - - - @ @ - - - - @ @ - @ @ - - - - - - - - - - - @ - - - - - - - - - - - - @ - @ -|
|@ @ @ - - - - - - - - - - - - - - - - - - - - @ - - - - - - - - - - - - - - - - - - - - - - - - - - - - - - @ - - - - - - @ @ - - - - @ - - - - - - - - - - - - - - - - - - - - - - - - - - - - - - @ -|
|- - @ @ @ - - - - - - @ @ @ - - - - - - - - - @ - - - - - - - - @ - - - - - - - - - - - - - - @ @ @ - - - @ @ - - - - - - @ @ @ - - - @ - - - - - - - - - - - - - - - - - - @ @ @ @ - - - - - - - - @ -|
|@ @ @ - - - - - - - - - - - - - - - - - - - - @ - - - - - - - - @ - @ - - - - - - - - - - @ @ @ @ @ @ - @ @ @ - - - - - - - - - - - - - - - - - - - - - - - - - - - - - - - @ @ - - - - - - - - - - - -|
|- - - - - - - - - - - - - @ @ @ - @ @ - - - - - - - @ @ @ - - - @ - @ - - - - - - - @ - - @ @ - @ @ @ - @ @ - - - - - @ @ @ - - - - - - - - @ @ @ @ - - - - - - - - - - @ @ @ @ @ - - - - - - - - - - -|
|- - - - - - - - - - - - - - - - - @ @ - - - - - - - - - - - - - - - @ - - - - - - @ @ - - - - - - - @ @ @ - - - - - - - - - - - - - - - - - - @ @ @ - - - - - - - - - - @ @ - @ @ - - - - @ @ - @ @ - -|
|- - - - - - - - - - - - - - - - - - @ - - - - - - - - - - - - - - - - - - - - - - @ @ - - - - - - - - @ @ - - - - - - - - - - @ @ @ - - - - - - - - - - - - - - - - - - - - - @ @ - @ @ - @ @ - @ @ - -|
|- - - @ - - - - - - - - @ @ - - - - @ @ @ - - - - - - @ @ @ - - - - @ @ @ @ - - - @ - - - - - - - - - @ - - - - - @ - - - - - - - @ @ - - - - - - - - - - - @ @ - - - - - - - - - - @ @ - - - - - - - -|
|- - - @ - - @ - - - - - @ @ - - - - @ @ - - - - - - - - - - - - - @ @ - - - - - - - - - - - - - - - - - - - - - - @ - - - - - - - - @ - - - - - - - - - - - @ @ - - - - - - - - - - - - - - - - - - - -|
|- - - @ - - @ @ @ - - - - - - - - - - - - - - - - - - - - - - - @ @ @ @ @ - - - - - - - - - - - - - @ @ @ - - - - @ - - - - - - - - @ - - - - - - - - - - - - - - - - - - - - - - - - - @ @ @ @ - - - @|
|- - - - - @ @ - - - - - - - - - - - - - - - - - - - - - - - - - @ - - @ @ @ @ - - - - @ @ @ - - @ @ @ @ - - - - - - - - - - - - - - - - - - - - - - - - - - - - @ @ @ - @ - - - - - - - - - - @ - - - @|
|- - - - - @ @ - - - - - - - - - @ - - - - - - - - - - - - - - - @ - - - - @ @ - @ - - - - - - - @ - - @ @ - - - @ - - - - - - @ @ - - - - - - @ @ - - - - - - - - - @ @ @ - - - - - - - - - - @ - - - -|
|- - - - - - @ - - - - - - - - - @ - - - - - - - - - - - - - - - - - - - - - - - @ - - - - - - - @ - - @ @ @ - - @ - - - - - - @ @ - - - - - - @ @ - - - - - - - - - @ @ @ - - - - - - - - - - - - - - -|
|- - - - - - @ - - - - - - - - - @ - - - - - - - - - - - - - - - - - - - - - - - @ - - - - - - @ @ - @ @ @ @ - - @ - - - - - - - - - - - - - - - - - - - - - - - - - - - - - - - @ @ @ - - - - @ @ @ - -|
|- - - @ @ @ @ @ - - - - - - - - @ @ @ - - - - - - - @ @ @ - - @ @ - - - - - - - @ - - - - - - @ @ - @ @ - - - - - - - - - - - @ @ - - - - @ @ - - - - @ - - - - - - - - - - - - - @ - - - - - - @ - - @|
|- - @ @ - - @ @ - - - - - - - - - - - - - - - - - - - - - - - @ @ - - - - - - - @ - - - - - - - @ @ @ - - - - - - @ - - - @ @ @ @ - @ @ @ @ @ - - - - @ - - - - - - - - - - - - - @ @ @ @ - - - @ - - @|
|- - @ - - - - - - - - - - @ @ - - - - - - - - - - - - - - - - - @ - - - - - - @ @ @ - - - - - @ @ @ - - - - - - - @ - - - - - - - - - - - - - - - - - @ - - - - - - @ - - - - - - - - - - - - - @ - - @|
|- - @ - - - - - - - - - - @ @ - - - - - - - - - - - - - - - - - @ - - @ @ @ - @ @ @ - - - - - @ @ @ @ - - @ @ - - @ - - - - - - - - - - - - - - - - - @ - - - - - - @ - - - - - - - - - - - - - - - @ @|
|- - - - - - - - - - @ @ - - - - - - - - - - - - - @ @ @ @ @ - - @ - - - - - - - - @ - - - - - - @ @ - - - @ @ @ @ @ - - - - - - - - - - - - - - - - - @ - - - - - - @ - @ @ - - - - - - - - - - - - @ -|
