114 110
|@ @ @ @ @ @ @ @ @ @ @ @ @ @ @ @ @ @ @ @ @ @ @ @ @ @ @ @ @ @ @ @ @ @ @ @ @ @ @ @ @ @ @ @ @ @ @ @ @ @ @ @ @ @ @ @ @ @ @ @ @ @ @ @ @ @ @ @ @ @ @ @ @ @ @ @ @ @ @ @ @ @ @ @ @ @ @ @ @ @ @ @ @ @ @ @ @ @ @ @ @ @ @ @ @ @ @ @ @ @ @ @ @ @|
|@ @ @ @ @ @ @ @ @ @ @ @ @ @ @ @ @ @ @ @ @ @ @ @ @ @ @ @ @ @ @ @ @ @ @ @ @ @ @ - - - - - - - - - - - - - - - - - - - - - - - - - - - - @ @ @ @ @ @ @ @ @ @ @ @ @ @ @ @ @ @ @ @ @ @ @ @ @ @ @ @ @ @ @ @ @ @ @ @ @ @ @ @ @ @ @ @ @ @ @|
|@ @ @ @ @ @ @ @ @ @ @ @ @ @ @ @ @ @ @ @ @ @ @ @ @ @ @ @ @ @ @ @ @ @ @ @ @ @ - - - - - - - - - - - - - - - @ @ @ - @ @ @ - - - - - - - - @ @ @ @ @ @ @ @ @ @ @ @ @ @ @ @ @ @ @ @ @ @ @ @ @ @ @ @ @ @ @ @ @ @ @ @ @ @ @ @ @ @ @ @ @ @|
|@ @ @ @ @ @ @ @ @ @ @ @ @ @ @ @ @ @ @ @ @ @ @ @ @ @ @ @ @ @ @ @ @ @ @ @ @ - - - - - - - - - - - - - - - @ @ @ @ @ @ @ @ @ @ @ - - - - - - - - - - - - - @ @ @ @ @ @ @ @ @ @ @ @ @ @ @ @ @ @ @ @ @ @ @ @ @ @ @ @ @ @ @ @ @ @ @ @ @ @|
|@ @ @ @ @ @ @ @ @ @ @ @ @ @ @ @ @ @ @ @ @ @ @ @ @ @ @ @ @ @ @ @ @ @ @ @ @ - - - - - - - - - - - - - - - @ @ @ - @ @ @ - @ @ @ - - - - - - - - - - - - - - @ @ @ @ @ @ @ @ @ @ @ @ @ @ @ @ @ @ @ @ @ @ @ @ @ @ @ @ @ @ @ @ @ @ @ @ @|
|@ @ @ @ @ @ @ @ @ @ @ @ @ @ @ @ @ @ @ @ @ @ @ @ @ @ @ @ @ @ @ @ @ @ @ @ @ - - - - - - - - - - - - - @ @ @ - - - - - - - - @ @ @ - - - - - - - - - - - - - - @ @ @ @ @ @ @ @ @ @ @ @ @ @ @ @ @ @ @ @ @ @ @ @ @ @ @ @ @ @ @ @ @ @ @ @|
|@ @ @ @ @ @ @ @ @ @ @ @ @ @ @ @ @ @ @ @ @ @ @ @ @ @ @ @ @ @ @ @ @ @ @ @ - - - - - - - - - - - - - - - - - - - - - - - - - - - - - - - - - - - - - - - - - - - @ @ @ @ @ @ @ @ @ @ @ @ @ @ @ @ @ @ @ @ @ @ @ @ @ @ @ @ @ @ @ @ @ @ @|
|@ @ @ @ @ @ @ @ @ @ @ @ @ @ @ @ @ @ @ @ @ @ @ @ @ @ @ @ @ @ @ @ @ @ @ - - - - - - - - - - - - - - @ @ @ - - - - - - - - - - - - - - - - - - - - - - - - - - - - @ @ @ @ @ @ @ @ @ @ @ @ @ @ @ @ @ @ @ @ @ @ @ @ @ @ @ @ @ @ @ @ @ @|
|@ @ @ @ @ @ @ @ @ @ @ @ @ @ @ @ @ @ @ @ @ @ @ @ @ @ @ @ @ @ @ @ @ @ @ - - - - - - - - - - - - - - - - - - - - - - - - - - - - @ @ @ - - - - - - - - - - - - - - - @ @ @ @ @ @ @ @ @ @ @ @ @ @ @ @ @ @ @ @ @ @ @ @ @ @ @ @ @ @ @ @ @|
|@ @ @ @ @ @ @ @ @ @ @ @ @ @ @ @ @ @ @ @ @ @ @ @ @ @ @ @ @ @ @ @ @ @ @ - - - - - - - - - - - - - @ @ @ - - - - - - - - - - - - @ @ @ - - - - - - - - - - - - - - - - - - - @ @ @ @ @ - @ @ @ @ @ @ @ @ @ @ @ @ @ @ @ @ @ @ @ @ @ @ @|
|@ @ @ @ @ @ @ @ @ @ @ @ @ @ @ @ @ @ @ @ @ @ @ - - @ @ @ @ @ @ @ @ @ @ - - - - - - - - - - - - - @ @ @ - - - - - - - - - - - - @ @ @ - - - - - - - - - - - - - @ @ @ - - - @ - @ @ @ - - - @ @ @ @ @ @ @ @ @ @ @ @ @ @ @ @ @ @ @ @ @|
|@ @ @ @ @ @ @ @ @ @ @ @ @ @ @ @ @ @ @ @ @ @ - - - - @ - - @ @ - - - @ @ - - - - - - - - - - - - @ @ @ - - - - - - - - - - - - - - - - - - - - - - - - - - - - - - @ @ - @ @ - @ @ @ - @ - @ @ @ @ @ @ @ @ @ @ @ @ @ @ @ @ @ @ @ @ @|
|@ @ @ @ @ @ @ @ @ @ @ @ @ @ @ @ @ @ @ @ @ - - - - - @ @ - - @ - - - @ @ - - - - - - - - - - - - - - - - - - - - - - - - - - - - - - - - - - - - - - - - - @ - - - - @ @ @ - - @ @ @ - @ - @ @ @ @ @ @ @ - - @ @ @ @ @ @ @ @ @ @ @ @|
|@ @ @ @ @ @ @ @ @ @ @ @ @ @ @ @ @ @ - - - - - - - - - @ @ - - - - - @ @ - - - - - - - - - - - - - - - - - - - - - - - - - - - - - - - - - - - - - - - - - @ @ - - - - - - - - @ @ @ - - - @ @ @ @ @ @ @ - - @ @ @ @ @ @ @ @ @ @ @ @|
|@ @ @ @ @ @ @ @ @ @ @ @ @ @ @ @ @ - - - - - - - - - - - @ @ - - - @ @ @ - - - - - - - - - - - - - - - - - - - - - - - - - - - - - - - - - - - - - - - - - @ @ @ @ - - - - - - - - - - - - @ @ @ @ @ @ @ - - - @ @ @ @ @ @ @ @ @ @ @|
|@ @ @ @ @ @ @ @ @ @ @ - - - - - - - - - - - - - - - - - - @ @ - - - @ @ - - - - - - - - - - - - - - - - - - - - - - - - - - - - - - - - - - - - - - - - - - @ @ @ - - - - - - - - - - - - @ @ @ @ @ @ @ - - - @ @ @ @ @ @ @ @ @ @ @|
|@ @ @ @ @ @ @ @ @ @ - - - - - - - - - - - - - - - - - - - - @ @ - - - @ - - - @ @ @ - - - - - - - - - - - - - - - - - - - - - - - - - - - - - - - - - - - - - @ - - - - - - - - - - - - - @ @ @ @ @ @ @ @ @ - @ @ @ @ @ @ @ @ @ @ @|
|@ @ @ @ @ @ @ @ @ - - - - - - - - - - - - - - - - - - - - - @ @ - - @ @ @ - @ @ @ - - - - - - - - - - - - - - - - - - - - - - - - - - - - - - - - - - - - - @ @ - - - - - - - - - - - - - @ @ @ @ @ @ @ - - - @ @ @ @ @ @ @ @ @ @ @|
|@ @ @ @ @ @ @ @ @ - - - - - - - - - - - - - - - - - - - - - @ @ - - - - @ @ @ @ - - - @ - - - - - - - - - - - - - - - - - - - - - - - - - - - - - - - - - @ @ - - - - - - - - - - - - - - - - - - - - - - - - - @ @ @ @ @ @ @ @ @ @|
|@ @ @ @ @ @ @ @ @ - - - - - - - - - - - - - - - - - - - - - - @ @ - - - - - - - - - @ @ - - - - - - - - - - - - - - - - - - - - - - - - - - - - - - - - - @ @ - - - - - - - - - - - - - - - - - - - - - - - - - - - - @ @ @ @ @ @ @|
|@ @ @ @ @ @ @ @ @ - - - - - - - - - - - - - - - - - - - - - - - @ @ - - - - - - - @ @ @ - - - - - - - - - - - - - - - - - - - - - - - - - - - - - - - @ @ @ - - - - - - - - - - - - - - - - - - - - - - - @ @ @ @ - - @ @ @ @ @ @ @|
|@ @ @ @ @ @ @ @ @ - - - - - - - - - - - - - - - - - - - - - - - @ @ - - - - - - - @ @ - - - - - - - - - - - - - - - - - - - - - - - - - - - - - - @ @ @ @ - - - - - - - - - - - - - - - - - - - - - - - - @ @ @ @ - @ @ @ @ @ @ @ @|
|@ @ @ @ @ @ @ @ @ - - - - - - - - - - - - - - - - - - - - - - - @ @ @ - - - - - - @ - - - - - - - - - - - - - - @ - - - - - - - @ @ @ - - - @ @ @ @ - - - - - - - - - - - - - - - - - - - - - - - - - - - @ @ @ @ - @ @ @ @ @ @ @ @|
|@ @ @ @ @ @ - - - - - - - - - - - - - - - - - - - - - - - - - @ @ @ - - - - - - - @ @ - - - - - - - - - - - - @ @ @ - - - - - @ @ - @ @ - @ @ @ - - - - - - - - - - - - - - - - - - - - - - - - - - - - - - - - - - - @ @ @ @ @ @ @|
|@ @ @ @ @ - - - - - - - - - - - - - - - - - - - - - - - - - @ @ @ @ - - - - - - - - @ @ @ @ @ - - - - - @ @ @ @ @ @ @ @ @ @ @ @ - - - @ @ @ - - - - @ @ @ @ - - - - - - @ @ @ @ @ - - - - - - - - - - - - - - - - - - @ @ @ @ @ @ @|
|@ @ @ @ @ - - - - - - - - @ @ @ - - - - - - - - - - - - - - @ @ @ @ - - - - - - - - - - @ @ @ @ - - - @ @ @ @ - @ @ @ @ @ @ @ - - - - @ - - - - - - @ @ @ @ - - - - - - @ @ @ @ @ - - - - - - - - - - - - - - - @ @ @ @ @ @ @ @ @ @|
|@ @ @ @ @ - - - - - - - - @ @ @ - - - - - - - - - - - - - - - @ @ @ - - - - - - - - - - - @ @ @ @ @ @ @ - - - - - - - - - - - - - - - - - - - - - - @ @ @ @ - - - - - - @ @ @ @ @ - - - - - - - - - - - - - - @ @ @ @ @ @ @ @ @ @ @|
|@ @ @ @ - - - - - - @ @ - @ @ @ - - - - - - - - - - @ @ @ - - - @ @ - - - - - - - - - - - - @ - @ @ @ - - - - - - - - - - - - - - - - - - - - - - - @ @ @ @ - - - - - - @ @ @ @ @ - - - - - - - - - - - - - @ @ - @ @ @ @ @ @ @ @ @|
|@ @ @ - - - - - @ @ - - - - - - - - - - - - - - - - @ @ @ @ - - - @ - - - - - - - - - - - - - - - - - - - - - - - - - - - - - - - - - - - - - - - - - - - - - - - - - - @ @ @ @ @ - - - - - - - - - - - - @ @ - - - - @ @ @ @ @ @ @|
|@ @ @ @ - - - - - - - - - - - - - - - - - - - - - - @ @ @ @ @ - - - - - - - - - - - - - - - - - - - - - - - - - - - - - - - - - - - - - - - - - - - - - - - - - - - - - @ @ @ @ @ - - - - - @ @ @ - - - - @ @ - - - - - @ @ @ @ @ @|
|@ @ @ @ - - @ @ @ - - - - - - - - - - - - - - - - - @ @ @ @ @ - - - - - - - - - - - - - - - - - - - - - - - - - - - - - - - - - - - - - - - - - - - - - - - - - - - - - @ @ @ @ @ - - - - @ @ @ @ - - - - - @ @ - - - - - @ @ @ @ @|
|@ @ @ @ - @ @ @ @ - - - - - - - - - - - - - - - - - - @ @ - - - - - - - - - - - - - - - - - - - - - - - - - - - - - - - - - - - - @ - - - - - - - - - - - - - - - - - - @ @ @ @ @ - - - - - @ @ @ @ @ @ - - - @ - - - - - @ @ @ @ @|
|@ - - - - @ @ @ - - - - - - - - - - - - - - - - - - - - @ - - - - - - - - - - - - - - - - - - - @ @ - - - - - - - - - - - - - - - @ - - - - - - - - - - - - - - - - - - - - @ @ @ - - - - - - @ - @ @ @ - - - - - - - - - @ @ @ @ @|
|@ @ - - - @ @ @ - - - - - - - - - - - - - - - - - - - - @ - - - - - - - - - - - - - - - - - - @ @ @ @ @ - - - - - - - - @ @ @ - - - - @ @ - - - - - - - - - - - - - - - - - - - - - - - - - @ @ - - @ @ @ - - - - - - - - @ @ @ @ @|
|@ @ @ - - @ @ @ @ - - - - - - - - - - - - - - - - - - - @ @ - - - - - - - - - - - - - - - - @ @ @ @ @ @ @ @ @ - - - - - @ @ @ @ - - @ @ @ @ - - - - - - - - - - - - - - - - - - - - - - - @ @ - - - - @ @ @ - - - - - - - @ @ @ @ @|
|@ @ @ - - - @ @ @ - - - - - - - - - - - - - - - - - - - @ @ - - - - - - - - - - - - - - - @ @ @ @ @ @ @ @ @ @ - - - - - - @ @ @ @ @ @ @ @ @ - - - - - - - - - - - - - - - - - - - - - - - @ - - - - - - - - - - - - - - - @ @ @ @ @|
|@ @ @ - - - - - - - - - - - - - - - - - - - - - - - - - - @ @ - - - - - - - - - - - - - @ @ @ @ @ @ @ @ @ @ @ - - - - - - @ @ @ @ @ @ @ @ @ - - - - - - - - - - - - - - - - - - - - - - - @ - - - - - - - - - - - - - - - @ @ @ @ @|
|@ @ - - - - - @ @ - - - - - - - - - - - - - - - - - - - - @ @ - - - - - - - - - - - - - @ @ @ @ @ @ @ @ @ @ @ @ - - - - - - @ @ @ @ @ @ @ - - - - - - - - - - - - - - - - - - - - - - - - @ @ - - - - - - - - - - - - - - - @ @ @ @|
|@ - - - - - @ @ @ @ - - - - - - - - - - - - - - - - - - @ @ - - - - - - - - - - - - - - - @ @ @ @ @ @ @ @ @ @ @ - - - - - - - @ @ @ @ @ @ @ - - - - - - - - - - - - - - - - - - - - - @ - - @ @ - - - - - - - - - - - - - - - @ @ @|
|- - - - - - - - @ @ - - - - - - - - - - - - - - - - - - @ - - - @ @ @ - - - - - - - - - - - @ @ @ @ @ @ @ @ @ @ - - - - - - - - @ @ @ @ @ @ - - - - - - - - - - - - - - - - - - - - - - - - @ @ - - - - - - - - - - - - - - - - @ @|
|- - - - - - - - - - - - @ @ @ - - - - - - - - - - - - - @ - - @ @ @ - - - - - - - - - - - - @ @ @ @ @ @ @ @ @ - - - - - - - - - @ @ @ @ @ @ - - @ @ - - @ @ - - - - - - - - - - - - - - - @ @ - - - - - - - - - - - - - - - - - - @|
|- - - - - - - - - - - - @ @ @ - - - - - - - - - - - - - @ @ - - - - - - - - - - - - - - - - @ @ @ @ @ @ @ @ @ @ - - - - - - - - @ @ @ @ @ @ @ @ @ @ @ @ @ @ @ - - - - - - - - - - - - - - @ - - - - - - - - - - - - - - - - - - - @|
|- - - - - - - - - - - - @ @ @ - - - - - - - - - - - - - - @ @ - @ @ @ - - - - - - - - - - - - @ @ @ @ @ @ @ @ @ - - - - - - - - - @ @ @ @ @ @ @ @ @ @ @ @ @ @ @ - - - - - - - - - @ - - - @ - - - - - - - - - - - - - - - - - - - @|
|- - - - - - - - - - - - - - - - - - - - - - - - - - - - - @ @ - - - - - - - - - - - - - - - - - @ @ @ @ @ @ @ - - - - - - - - - @ @ @ @ @ @ @ @ @ @ @ @ @ @ @ @ @ - - - - - - - - - - - @ @ - - - - - - - - - - - - - - - - - - - @|
|- - - - - - - - - - - - - - - - - - - - - - - - - - - - @ @ @ @ @ @ - - - - - - - - - - - - - - @ @ @ @ @ @ @ @ - - - - - - - - - @ @ - - @ @ @ @ @ @ @ @ @ @ @ - - - - - - - - - - - @ @ - - - - - - - - - - - - - - - - - - - - @|
|- - - - - - - - - - - - - - - - - - - - - - - - - - - - @ @ - - @ @ @ - - - - - - - - - - - - - @ @ @ @ @ @ @ @ @ - - - - - - - - - @ - - - @ @ @ @ @ @ @ @ @ @ @ - - - - - - - - - @ @ - - - - - - - - - - @ @ @ - - - - - - - - @|
|- - - - - - - - - - - - - - - - - - - - - - - - - - - - - @ @ - - - - - - - - - - - - - - - - - - @ @ @ @ @ @ @ @ @ - - - - - - - - - - - - @ @ @ @ @ @ @ @ @ @ @ - - - - - - - - @ @ - - - - - - - - - - - @ @ @ - - - - - - - - @|
|- - - - - - - - - - - - - - - - - - - - - - - - - - - - - @ @ @ - @ @ @ - - - - - - - - - - - - - - @ @ @ @ @ @ @ @ - - - - - - - - - - - - @ @ @ @ @ @ @ @ @ @ @ - - - - - - - - @ - - - - - - - - - - - - - - - - - @ @ @ - - - @|
|- - - - - - - - - - - - - - - - - - - - - - - - - - - - @ @ @ - - @ @ @ @ @ @ - - - - - - - - - - @ @ @ @ @ @ @ - - - - - - - - - - - - - - - @ @ - @ - - @ @ @ - - - - - - - - - @ - - - - - - - - - - - - - - - - - @ @ @ @ - - @|
|@ - - - - - - - - - - - - - - - - - - - - - - - - - - @ @ @ - - - - @ @ @ @ @ - @ @ @ - @ @ @ - @ @ @ @ @ @ @ @ - - - - - - - - - - - - - - - - @ - - - @ @ - - - - - - - - - - - @ - - - - - - - - - - - - - - - - - - @ @ @ - - @|
|@ @ - - - - - - - - - - - - - - - - - - - - - - - - @ @ @ - - - - - - - - - - - @ @ @ - @ @ - - @ @ @ @ @ @ @ @ - - - - - - - - - - - - - - - - - - - - @ @ - - - - - - - - - - @ @ - - - - - - - - - - - - - - - - - - @ @ @ - - @|
|@ @ @ - - - - - - - - - - - - - - - - - - - - - - - @ @ @ - - - - - - - - - - - - - - - - - - @ @ @ @ @ @ @ - - - - - - - - - - - - - - - - - - - - - - - - - - - - - - - - - - @ @ - - - - - - - - - - - - - - - - - - @ @ @ @ - @|
|@ @ - - - - - - - - - - - - - - - - - - - - - - - - @ @ @ @ - - - - - @ - - - - - @ @ @ @ @ @ @ - - - @ @ @ - - - - - - - - - - - - - - - - - - - - - - - - - - - - - - - - - @ @ - - - - - - - - - - - - - - - - - - - @ @ @ @ - @|
|@ - - - - - - - - - - - - - - - - - - - - - - - - @ @ @ - @ @ - - - @ @ @ - - - @ @ @ @ @ @ @ - - - @ @ @ - - - - - - - - - - - - - - - - - - - - - - - - - - - - - - - - - - @ - - - - - - - - - - - - - - - - - - - - @ @ @ - - @|
|@ @ - - - - - - - - - - - - - - - - - - - - - - @ @ @ - - - @ @ @ @ @ - @ @ @ @ @ - - - - - - - - - @ @ - - - - - - - - - - - - - - - @ @ - @ @ - @ @ - - - - - - - - - - - - @ - - - - - - - - - - - - - - - - - - - - - @ @ @ - @|
|@ @ @ - - - - - - - - - - - - - - - - - - - - @ @ @ - - - - - @ @ @ - - - @ @ @ - - - - - - - - - - @ - - - - - - - - - - - - - @ @ @ @ @ @ @ @ @ @ @ @ - - - - - - - - - - - @ - - - - - - - - - - - - - - - - - - - - @ @ @ @ - @|
|@ @ @ - - - - - - - - - - - - - - - - - - - - - @ @ @ - - - - - - - - - - - - - - - - - - - - - - - - - - - - - - @ @ - - - @ @ @ @ @ @ @ @ @ @ @ @ @ @ - - - - - - - - - - - @ @ - - - - - - - - - - - - - - - - - - - @ @ @ - - @|
|@ @ @ - - - - - - - - - - - - - - - - - - - - - - @ @ @ @ @ - - - - - - - - - - - - - - - - - - - - - - - - - - @ @ @ @ @ @ @ @ @ @ @ @ @ @ @ @ @ @ @ @ @ @ - - - - - - - - - @ @ @ - - - - - - - - - - - - - - - - - @ @ @ - - - @|
|@ @ @ - - - - - - - - - - - - - - - - - - - - - - - @ @ @ @ @ - - - - - - - - - - - - - - - - - - - - - - - - @ @ @ @ @ @ @ @ @ @ @ @ @ @ @ @ @ @ @ @ @ @ @ @ - - - - - - - - - @ - - - - - - - - - - - - - - - - - - @ @ @ - - - @|
|@ @ @ - - - - - - - - @ @ @ - @ @ @ @ - - - - - - - - - - @ @ @ - - - - - - - - - - - - - - - - - - - - - - @ @ @ - @ @ @ @ @ @ @ @ @ @ @ @ @ @ @ @ @ @ @ @ @ @ - - - - - - - @ @ - - - - - - - - - - - - - @ @ @ - - - - - - - - @|
|@ @ - - - - - - - - @ @ - @ @ @ - - @ @ - - - - - - - - - - @ @ - - - - @ @ @ - - - - - - - - - - - - - - - - - - - @ @ @ @ @ @ @ @ @ @ @ @ @ @ @ @ @ @ @ @ @ - - - - - - - - @ - - - - - - - - - - - - - - @ @ @ - - - - - - - - @|
|@ - - - - - - - - @ @ - - - @ - - - - @ - - - - - - - - - - @ @ - - - - @ @ @ - - - - - - - - - - - - - - - - - - - @ @ @ @ @ @ @ @ @ @ @ @ @ @ @ @ @ @ @ @ - - - - - - - - - @ - - - - - - - - - - - - - - - @ @ - - - - - - - - @|
|@ - - - - - - - - @ @ - - - - - - - - @ - - - - - - - - - - @ @ - - - - @ @ @ - - - - - - - - - - - - - - - - - - - @ @ - - - - - - - @ @ @ @ - - @ @ @ @ - - - - - - - - - - @ @ - - - - - - - - - - - - - - - - - - - - - - - - @|
|@ @ - - - - - - - @ @ @ - - - - - - - @ - - - - @ @ - - - - @ @ - - - - - - - - - - - - - - - - - - - - - - - - - - @ @ - @ @ - - - - - @ @ - - - - @ @ - - - - - - - - - - - @ @ @ - - - - - - - - - - - - - - - - - - - - - - - @|
|@ @ @ - - - - - - - @ @ @ - - - - - - @ @ - @ @ @ @ @ - - @ @ @ - - - - - - - - - - - - - - - - - - - - - - - - - - @ @ - @ @ - - - - - - - - - - - - - - - - - - - - - - - - - @ @ - - - - - - - - - - - - - - - - - - - - - - @ @|
|@ @ @ - - - - - - - - @ @ - - - - - - - @ @ @ @ @ @ @ @ @ @ @ @ @ - - - - - - - - - - - - - - - - - - - - - - - - @ @ - - @ @ - - - - - - - - - - - - - - - - - - - - - - - - - - @ - - - - - - - - - - - - - - - - - - - - - - @ @|
|@ @ @ @ @ @ - - - - - - - - - - - - - - @ @ @ @ @ @ @ @ @ @ @ @ @ - - - - - - - - - - - - - - - - - - - - - - - @ @ - - - - - - - - - - - - - - - - - - - - - - - - - - - - - - - @ @ - - @ @ @ - - - - - - - - - - - - - - - @ @ @|
|@ @ @ @ @ @ @ - - - - - - - - - - - - - @ @ @ @ @ @ @ @ @ @ @ @ @ - - - - - - - - - - - - - - - - - - - - - - - @ @ - - - @ @ - - - - - - - - - - - - - - - - - - - - - - - - - - - @ @ @ @ @ - - - - - - - - - - - - - - - - @ @ @|
|@ @ @ - @ @ @ @ - - - - - - - - - - - - - - @ @ @ @ @ @ @ @ @ @ @ - - - - - - - - - - - - - - - - - - - - - - - @ @ - - - @ @ - - - - - - - - - - - - - - - - - - - - - - - - - - - - @ @ @ - - - @ - - - - - - - - - - - - - @ @ @|
|@ @ @ - - @ @ @ - - - - - - - - - - - - - - @ @ @ @ @ @ @ @ @ @ @ @ @ - - - - - - - - - - - - - - - - - - - - @ @ - - - - @ @ - - - - - - - - - - - - - - - - - - - - - - - - - - - - - - - - - @ @ - - - - - - - - - - - - - @ @ @|
|@ @ @ - - - @ @ - - - - - - - - - - - - - - @ @ @ @ @ @ @ @ @ @ @ @ @ @ - - - - - - - - - - - - - - - - - - @ @ - - - - - - - - - - - - - - - - - - - - - - - - - - - - - - - - - - - - - - - @ @ @ - - - - - - - - - - - - - @ @ @|
|@ @ @ - - - - - - - - - - - - - - - - - - - @ @ @ @ @ @ @ @ @ @ @ @ @ @ @ - - - - - - - - - - - - - - - - - @ @ - - - - - @ @ @ - - - - - - - - - - - - - - - - - - - - - - - - - - - - - - - @ @ - - - - - - - - - - - - - - @ @ @|
|@ @ @ @ - - - - - - - - - - - - - - - - - - @ @ @ @ @ @ @ @ @ @ @ @ @ @ @ @ - - - - - - @ @ @ - - - - - - - @ @ - - - - @ @ @ @ - - - - - - - - - - - - - - - - - - - - - - - - - - - - - - - @ @ @ @ - - - - - - - - - - - - @ @ @|
|@ @ @ @ @ - - - - - - - - - - - - - - - - - @ @ @ @ @ @ @ @ @ @ @ @ @ @ @ @ - - - - - - @ @ @ - - - - - - - @ @ - - - - @ @ @ @ @ - - - - - - - - - - - - - - - - - - - - - - - - - @ - - - - - @ @ @ @ - - - - - - - - - - - @ @ @|
|@ @ @ @ @ @ - - - - - - - - - - - - - - - - @ @ @ @ @ @ @ @ @ @ @ @ @ @ @ @ @ - - - - - - - - - - - - - - - @ @ - - - - - - @ @ @ @ - @ @ - @ @ @ @ @ - - - - - - - - - @ @ - @ @ - @ @ - - - - - - - @ @ @ @ @ @ - - - - - - @ @ @|
|@ @ @ @ @ @ @ - - - - - - - - - - - - - - - @ @ @ @ @ @ @ @ @ @ @ @ @ @ @ @ @ @ @ @ @ - - - - - - - - - - - - @ @ - - - - - - - @ @ - @ @ @ @ @ @ @ @ - - - - - - - - - @ @ @ @ @ @ @ @ @ @ - - - - - - @ @ @ @ @ @ - - - - - @ @ @|
|@ @ @ @ @ @ @ - - - - - - - - - - - - - - - @ @ @ @ @ @ @ @ @ @ @ @ @ @ @ @ @ @ @ @ @ @ - - - - @ @ @ - - - - - @ @ - - @ @ @ - - - - - @ @ - - - - @ @ - - - - - @ - - - @ @ @ @ @ - - - @ @ @ @ - - - - - - - - @ @ - - - - @ @ @|
|@ @ @ @ @ @ @ - - - - - - - - - - - - - - - - - @ @ @ @ @ @ @ @ @ @ @ @ @ @ @ @ @ @ @ @ @ - - @ @ @ @ @ - - - - @ @ - @ @ @ @ @ - - - - - - - - - - @ @ @ @ @ - - @ @ - - - @ @ @ - - - - - @ @ @ @ - - - - @ @ - - @ @ @ - @ @ @ @|
|@ @ @ @ @ @ @ - - - - - - - - - - - - - - - - - - @ @ @ @ @ @ @ @ @ @ @ @ @ @ @ @ @ @ @ @ @ @ @ - - @ @ @ - - - @ @ @ @ - - - @ @ @ @ - - - - @ @ @ @ - @ @ @ @ - @ @ @ - - - - - - - - - - - - - @ @ @ @ - @ @ - - - @ @ @ @ @ @ @|
|@ @ @ @ @ @ @ - - - - - - - - - - - - - - - - - - - @ @ @ @ @ @ @ @ @ @ @ @ @ @ @ @ @ @ @ @ @ - - - - @ @ @ - - - @ @ @ - - - - @ @ @ @ - - @ @ @ @ - - - @ @ @ @ @ @ @ @ - - - - - - - - - - - - - @ @ @ - - - - - - @ @ @ @ @ @ @|
|@ @ @ @ @ @ @ - - - - - - - - - - - - - - - - - - - - @ @ @ @ @ @ @ @ @ @ @ @ @ @ @ - - - - - - - - - - @ @ @ - @ @ @ @ - - - - - - - @ @ @ @ - - - - - - - - - @ @ @ @ @ - - - - - - - - - - - - - - - @ @ @ @ @ @ @ @ @ @ @ @ @ @|
|@ @ @ @ @ @ @ - - - - - - - - - - - - - - - - - - - - - @ @ @ @ @ @ @ @ @ @ @ @ @ - - - - - - - - - - - - @ @ @ @ @ @ @ - - - - - - - - @ @ - - - - - - - - - - - @ @ @ @ - - - - - - - - - - - - - - - - - @ @ @ @ @ @ @ @ @ @ @ @|
|@ @ @ @ @ @ @ - - - - - - - - - - - - - - - - - - - - - @ - - - - - - - - - - @ @ - - - - - - - - - - - - @ @ @ - - - - - - - - - - - - - - - - - - - - - - - - - - - - - - - - - - - - - - - - - - - - - - - @ @ @ @ @ @ @ @ @ @ @|
|@ @ @ @ @ @ @ - - - - - - - - - - - - - - - - - - - - - - - - - - - - - - - - - @ @ - - - - - - - - - - - @ @ - - - - - - - - - - - - - - - - - - - - - - - - - - - - - - - - - - - - - - - - - - - - - - - - - @ @ @ @ @ @ @ @ @ @|
|@ @ @ @ @ @ @ - - - - - - - - - - - - - - - - - - - - - - - - - - - - - - - - - - @ @ @ @ - - - - - - - - - - - - - - - - - - - - - - - - - - - - - - - - - - - - - - - - - - - - - - - - - - - - - - - - - - - - @ @ @ @ @ @ @ @ @|
|@ @ @ @ @ @ @ - - - - - - - - - - - - - - - - - - - - - - - - - - - - - - - - - - - - - @ @ - - - - - - - - - - - - - - - - - - - - - - - - - - - - - - - - - - - - - - - - - - - - - - - - - - - - - - - - - - - - @ @ @ @ @ @ @ @|
|@ @ @ @ @ @ - - - @ @ - - - - - - - - - - - - - - - - - - - - - - - - - - - - - - - - - - @ @ @ @ - - - - - - - - - - - - - - - - - - - - - - - - - - - - - - - - - - - - - - - - - - - - - - - - - - - - - - - - - @ @ @ @ @ @ @ @|
|@ @ @ @ @ - - - - @ @ - - - - - - - - - - - - - - - - - - - - - - - - - - - - - - - - - - - - - @ - - - - - - - - - - - - - - - - - - - - - - - - - - - - - - - - - - - - - - - - - - - - - - - - - - - - - - - - - @ @ @ @ @ @ @ @|
|@ @ @ @ @ - - - - @ @ - - - - - - - - - - - - - - - - - - - - - - - - - - - - - - - - - - - - - @ - - - - - - - - - - - - - - - - - - - - - - - - - - - - - - - - - - - - - - - - - - - - - - - - - - - @ @ @ @ @ @ @ @ @ @ @ @ @ @|
|@ @ @ @ @ - - - - - - - - - - - - - - - - - - - - - - - - - - - - - - - - - - - - - - - - - - - @ - - - - - - - - - - - - - - - - - - - - - - - - - - - - - - - - - - - - - - - - - - - - - - - - - - - @ @ @ @ @ @ @ @ @ @ @ @ @ @|
|@ @ @ @ @ - - - - @ @ @ - - - - - - - - - - - - - - - - - - - - - - - - - - - - - - - - - - - - @ - - - - - - - - - - - - - - - - - - - - - - - - - - - - - - - - - - - - - - - - - - - - - - - - - - - @ @ @ @ @ @ @ @ @ @ @ @ @ @|
|@ @ @ @ @ - - - @ @ @ - - - - - - - - - - - - - - - - - - - - - - - - - - - - - - - @ @ @ - - @ @ - - - - - - - - - - - - - - - - - - - - - - - - - - - - - - - - - - - - - - - - - - - - - - - - - - - @ @ @ @ @ @ @ @ @ @ @ @ @ @|
|@ @ @ @ @ - - - @ @ @ @ - - - - - - - - - - - - - - - - - - - - - - - - - - - - - - @ @ @ @ @ @ @ - - - - - - - - - - - - - - - - - - - - - - - - - - - - - - - - - - - - - - - - - - - - - - - - - - - @ @ @ @ @ @ @ @ @ @ @ @ @ @|
|@ @ @ @ @ - - - - @ @ @ - - - - - - - - - - - - - - - - - - - - - - - - - - - - - - - @ @ @ @ - - - - - - - - - - - - - - - - - - - - - - @ @ @ - - - - - - - - - - - - @ @ @ - - - - - - - - - - - - - @ @ @ @ @ @ @ @ @ @ @ @ @ @|
|@ @ @ @ @ - - - - @ @ @ - - - - - - - - - - - - - - - - - - - - - - - - - - - - - - - - @ @ - - - - - - - - - - - - - - - - - - - - - - - @ @ @ - - - - - - - - - - - - @ @ @ - - - - - - - - - - - - @ @ @ @ @ @ @ @ @ @ @ @ @ @ @|
|@ @ @ @ @ @ - - - @ @ @ @ - - - - - - - - - - - - - - - - - - - - - - - - @ - - - - - - - - - - - - - - - - - - - - - - - - - - - - - - - - @ @ - - - - - - - - - - - - @ @ @ - - - - - - - - - - - @ @ @ @ @ @ @ @ @ @ @ @ @ @ @ @|
|@ @ @ @ @ @ @ - - - @ @ @ @ @ @ - @ @ @ - - @ @ @ - - - - - - - - - - - - @ @ - - - - - - - - - - - - - - - - - - - - - - - - - - - - - - - - - - - - - - - - - - - - - - - - - - - - - - - - - - @ @ @ @ @ @ @ @ @ @ @ @ @ @ @ @ @|
|@ @ @ @ @ @ @ @ - - - - - @ @ @ @ @ @ @ - - @ @ @ - - - - - - - - - - - - @ @ @ - - - - - - - - - - - - - - - - - - - - - - - - - - - - - @ @ - - - - - - - - - - - - - - - - - - - - - - - - - - @ @ @ @ @ @ @ @ @ @ @ @ @ @ @ @ @|
|@ @ @ @ @ @ @ @ @ - - - - - - - @ @ @ - - - - - - - - - - - - - - - - - - - @ @ @ - - - - - - - - - - - - - - - - - - - - - - - - - - - - - @ @ @ - - - - - - - - - - - @ @ - - - - - - - - - - - @ @ @ @ @ @ @ @ @ @ @ @ @ @ @ @ @|
|@ @ @ @ @ @ @ @ @ @ - - - - - - - - - - - - - - - - - - - - - - - - - - - - - @ @ - - - - - - - - - - - - - - - - - - - - - - - - - - - - - - - - - - - - - - - - - - @ @ - - - - - - - - - - - @ @ @ @ @ @ @ @ @ @ @ @ @ @ @ @ @ @|
|@ @ @ @ @ @ @ @ @ @ @ - - - - - - - - - - - - - - - - - - @ @ @ @ @ @ @ @ @ @ @ @ - - - - - - - - - - - - - - - - - - - - - - - - - - - - - - - - @ @ @ - @ @ @ @ @ - - - - - - - - - - - - - @ @ @ @ @ @ @ @ @ @ @ @ @ @ @ @ @ @ @|
|@ @ @ @ @ @ @ @ @ @ @ @ - - - - - - - - - - - - - - - - @ @ @ @ @ @ @ @ @ @ @ @ @ - - - - - - - - - - - - - @ - - - @ - - - - - - - - - - - - - - - - - @ @ @ - - - - - - - - - - - - - @ @ @ @ @ @ @ @ @ @ @ @ @ @ @ @ @ @ @ @ @ @|
|@ @ @ @ @ @ @ @ @ @ @ @ @ - - - - - - - - - - - - - - @ @ @ @ @ @ @ @ @ @ @ @ @ @ - - - - - - - - - - - - @ @ @ - @ @ @ - - - - - - - - - - - - - - - - - - - - - - - - - - - - - - - @ @ @ @ @ @ @ @ @ @ @ @ @ @ @ @ @ @ @ @ @ @ @|
|@ @ @ @ @ @ @ @ @ @ @ @ @ @ @ @ @ @ @ @ @ @ @ @ @ @ @ @ @ @ @ @ @ @ @ @ @ @ @ @ @ @ - - - - - - - - - - @ @ @ @ @ @ @ @ - - - - - - - - - - - - - - - - - - - - - - - - - - - - - - - @ @ @ @ @ @ @ @ @ @ @ @ @ @ @ @ @ @ @ @ @ @ @|
|@ @ @ @ @ @ @ @ @ @ @ @ @ @ @ @ @ @ @ @ @ @ @ @ @ @ @ @ @ @ @ @ @ @ @ @ @ @ @ @ @ @ @ - - - - - - - - @ @ @ @ @ @ @ @ @ - - - - - - - - - - - - - - - - - - - - - - - - - - - - - - - @ @ @ @ @ @ @ @ @ @ @ @ @ @ @ @ @ @ @ @ @ @ @|
|@ @ @ @ @ @ @ @ @ @ @ @ @ @ @ @ @ @ @ @ @ @ @ @ @ @ @ @ @ @ @ @ @ @ @ @ @ @ @ @ @ @ @ - - - - @ @ @ @ @ @ @ @ @ @ @ @ @ @ @ @ @ @ @ @ @ - - - - - - - @ @ @ - - - - - @ @ @ @ @ @ @ @ @ @ @ @ @ @ @ @ @ @ @ @ @ @ @ @ @ @ @ @ @ @ @|
|@ @ @ @ @ @ @ @ @ @ @ @ @ @ @ @ @ @ @ @ @ @ @ @ @ @ @ @ @ @ @ @ @ @ @ @ @ @ @ @ @ @ @ - - - @ @ @ @ @ @ @ @ @ @ @ @ @ @ @ @ @ @ @ @ @ @ @ - - - - - @ @ @ @ @ - - - @ @ @ @ @ @ @ @ @ @ @ @ @ @ @ @ @ @ @ @ @ @ @ @ @ @ @ @ @ @ @ @|
|@ @ @ @ @ @ @ @ @ @ @ @ @ @ @ @ @ @ @ @ @ @ @ @ @ @ @ @ @ @ @ @ @ @ @ @ @ @ @ @ @ @ @ @ @ @ @ @ @ @ @ @ @ @ @ @ @ @ @ @ @ @ @ @ @ @ @ @ @ @ @ @ @ @ @ @ @ @ @ @ @ @ @ @ @ @ @ @ @ @ @ @ @ @ @ @ @ @ @ @ @ @ @ @ @ @ @ @ @ @ @ @ @ @|
|@ @ @ @ @ @ @ @ @ @ @ @ @ @ @ @ @ @ @ @ @ @ @ @ @ @ @ @ @ @ @ @ @ @ @ @ @ @ @ @ @ @ @ @ @ @ @ @ @ @ @ @ @ @ @ @ @ @ @ @ @ @ @ @ @ @ @ @ @ @ @ @ @ @ @ @ @ @ @ @ @ @ @ @ @ @ @ @ @ @ @ @ @ @ @ @ @ @ @ @ @ @ @ @ @ @ @ @ @ @ @ @ @ @|
|@ @ @ @ @ @ @ @ @ @ @ @ @ @ @ @ @ @ @ @ @ @ @ @ @ @ @ @ @ @ @ @ @ @ @ @ @ @ @ @ @ @ @ @ @ @ @ @ @ @ @ @ @ @ @ @ @ @ @ @ @ @ @ @ @ @ @ @ @ @ @ @ @ @ @ @ @ @ @ @ @ @ @ @ @ @ @ @ @ @ @ @ @ @ @ @ @ @ @ @ @ @ @ @ @ @ @ @ @ @ @ @ @ @|
