20 6
|- - - - - - - @ - - - - - - @ @ @ - - -|
|- - - - - - - @ - - - - - - @ @ @ - - -|
|- @ - @ @ @ - - - - - - - - @ - - - - -|
|- @ - - - - - - @ - - - - - - - - - - -|
|- @ @ @ - - - - @ @ @ - - - - - - @ - -|
|@ @ - - - - - - @ - - - - - - - - @ - @|
