20 200
|- - - - - @ - - - @ @ @ @ @ @ - - - @ @|
|- - - - - @ - - - - - - @ @ @ - @ @ @ -|
|- - - - - @ - - - - - - @ @ @ @ @ - - -|
|- - - - - - - - - - - - @ - - - - - - -|
|- - @ @ @ - @ @ - - @ - - - - - @ - - -|
|- - - - @ @ @ @ - - @ - - - - - @ - - -|
|- - - - - - - @ @ @ @ @ @ - - - @ - - -|
|- - - - - - - - - - - - - - @ - - - - -|
|- - - - - - - - - - - - - - @ - - - - -|
|- - - - - @ - - - - - - - - @ - - - - -|
|- - - - - @ - - @ @ - - - - - - - - - -|
|- - - - - @ - - @ @ - - - - - - - - @ @|
|- - - @ - - - - - - - - - @ - - - - @ @|
|- - - @ - - - - - - - - @ @ - - - - - -|
|- - - @ - @ @ @ - - - @ @ @ - - - - - @|
|- - - - - - - - - - @ @ @ - - - - - - @|
|- - - - @ @ - - @ @ @ - - - - - - - @ @|
|- - - - @ @ - - @ @ @ - - - - - - - @ @|
|- - - - - - - - @ @ - - - - - @ @ - - -|
|- - - - - - @ @ @ - - - - - - @ @ - - -|
|- - - - - - - - - - - - - - - - - - - -|
|- - - - - - - - - - - - - - - - - - - -|
|- - - - - - - - - - - - - - - - - - - -|
|- - - @ @ - - - - - - - - - - - - - - -|
|- - - @ @ - @ - @ @ @ - - - - - - - - -|
|- - - - - - @ - - @ @ - - - - - - @ @ -|
|- - - - - - @ - - @ @ - - - - - - @ @ -|
|- - - - - - - - - - - - - - - - - @ @ -|
|- - - - - - - @ @ @ @ @ - - - - - @ @ -|
|- @ @ @ - - - - - - - - - - - - - - - -|
|- - - - - - - - - - - - @ @ @ @ - - - -|
|- - - - - - @ @ @ - @ @ @ - - - - - - -|
|- - - - - - - - - - @ @ - - - - - - - -|
|- @ - - - - @ - - - @ @ @ - - - - - - -|
|- @ - - - - @ @ @ - - - @ - - - - - - -|
|- @ @ @ @ - @ @ @ - - - @ - - - - - - @|
|- - - - - - - - - - - - @ - @ @ @ - - @|
|- - - - - @ @ @ - - - - @ - @ @ @ - - -|
|- - - - - - - - - - - - - - @ - @ - - -|
|- - - - @ @ - - - @ - - - - - - @ - - -|
|- - - - @ @ @ - - @ - - - - - - @ - - -|
|- - - - - - - - - @ - - - - - - - - - -|
|- - - - - - - - - @ @ - - - - - - @ - -|
|- - - - - @ - - @ @ @ - - - - - - @ - -|
|- - - - - @ - - @ @ @ - - - - - - @ - -|
|- - - - - @ - - @ @ @ - - - - - - - - -|
|- - - - - - - - @ - - - - - - - - - - -|
|- - @ @ @ - - - - - - - - - - - - - - -|
|- - - - - - - - - - - - - - - - - - - -|
|- - - - - - - - - - - - - - - - - - - -|
|- - - - - - - - - - - - - - - - @ @ - -|
|- - - - - - - - - - @ @ @ @ - - @ @ - -|
|- - - - - - - - - - @ - - - - - - - - @|
|- - - - - - - - - - @ - - - - - - - - @|
|- - - - - - - - - - @ - - - - - - - - -|
|- - - - - - @ - - - - - - - - - - - - -|
|- - - - - - @ - - @ - - - - - - - - - -|
|- - @ - @ @ @ @ @ @ - - - - - - - - - -|
|- - @ - @ @ - - @ @ - - - - - - - - - -|
|- - @ @ @ - - - - - - - @ - - - - - - -|
|- - - - - - - - - - @ @ @ - - - - @ - -|
|- @ @ @ - - - - - - - - @ @ - - - @ - -|
|- - - - - - @ - - - - - - @ - - - @ - -|
|@ - - - - - @ - - - - - - @ - - - - - -|
|@ - - - - - @ @ @ @ - - - @ - - - - - -|
|@ - - - - - - - - - - - - - - - - - - -|
|- - - - - - - @ - @ @ @ @ - - - - - - -|
|- - - - - - - @ - @ @ - @ @ @ - - - - -|
|- - - - - - - @ @ @ @ @ @ @ @ - - - - -|
|- - - - - - - - @ @ @ @ @ - @ - - @ - -|
|@ @ - - - - - - - - @ - - - - - - @ - -|
|@ @ - - @ @ - - - @ @ - - - - - @ @ - -|
|- - - - @ @ - - - @ @ - - - - @ @ - - -|
|- - - - - - - - - @ - - - - - @ @ - - -|
|- @ - - - - - - - @ @ - - - - - - - - -|
|- @ - - - - - - - @ @ - - - - - - - - -|
|- @ - - - - - - - - @ - - - - - - - - -|
|- - - - - - - - - - - - - - - - - - - -|
|- @ @ - - - - - - - - - - - - - - - - -|
|- @ @ - - - - - - - - - - - - - - - - -|
|- - - - @ @ @ - - - @ @ - - - - - - - -|
|- - - - - - @ @ @ - @ @ - - - - - - - -|
|- - - @ @ - - @ @ - - - - - - - - @ @ -|
|- - - @ @ - - - - - - - - - - - - @ @ -|
|- - - - - - - - - - - - - - - - - - @ @|
|- - - - - - - - - - - - - - - - - @ @ @|
|- - - - - - - - - - - - - - - - - - - -|
|- - - - - - - - - - @ - - - - - - - - -|
|- - - - - - - - - - @ - - - - @ @ - - -|
|- - - - - - @ @ - - @ @ @ - - @ @ - - -|
|- - - - - @ @ @ - - @ @ @ - - - - - - -|
|- - - - - @ - - - - - - - - - - - - - -|
|@ @ - - - @ - - - - - - - @ - - - - - -|
|@ @ - @ @ @ - - - - - - - @ - - - - - -|
|- - - - - - - - - - - - - @ - - - - - -|
|@ - - @ - - - - - @ @ @ - - - - - - - -|
|@ - - @ - - - - - - - - - - - - - - - -|
|@ - - @ - - @ - - - - - - - - - - - - -|
|- - @ @ - - @ - - - - - @ @ @ - - - - -|
|- - @ @ - - @ - - - - - - - - - - - - -|
|@ @ @ - - - - - - - - @ @ - - - - - - -|
|- - - - - - - - - - - @ @ - - - - - - -|
|- @ - - - - - - - - - - @ @ @ - - - - -|
|- @ - - - - @ @ - - - - - - @ - - @ @ @|
|- @ - - - - @ @ - - - - - - @ @ @ @ - -|
|- - - - - - @ @ - - - - - - @ - - - - -|
|- - - - - - - @ @ @ - @ @ - - - - - - -|
|- - - - @ @ @ @ - @ @ @ @ @ @ @ - - - -|
|- - - - - - - - - @ @ - - @ - - - - - -|
|@ @ - @ @ @ - - - - - - - @ - - - - - -|
|@ @ - - - - - - - - - - - @ - - - - - -|
|- - - - - - - - - - - - @ @ - - - - - -|
|- @ @ - - - - - - - @ @ @ @ - - - - - -|
|@ @ @ - - - - - - @ @ - - - - - - - - -|
|@ - - - - - - - - @ @ - - - - @ @ @ - -|
|@ - - - - @ @ @ - - @ - - - - @ @ @ - -|
|- - - - - - - - - - - - - - - - @ @ @ @|
|- - - - - - - - - - - - - @ @ - - - @ -|
|- - - - - - - - - - - - - @ @ - - - @ -|
|- - @ @ @ - - - - - - - - - - - - - @ @|
|- - - - - - @ @ @ - - - - - - - - - - @|
|- @ @ - - - - @ - - - - - - - - - - @ @|
|- @ @ @ - - @ @ - - - - - - - - - - - -|
|- - - @ @ @ @ - - - - - - - - - - - - -|
|- - - @ @ - @ @ - - - - - - - - - - - -|
|- - - - - - @ @ - - - - - - - - - - - -|
|- - - - - - - - - - - - - - @ - - - - -|
|- - - - - - - - - - - - - - @ - - - - -|
|- - - - - - - - - - - - - - @ - - - - -|
|- - - - - - - - - - - - - - - - @ - - -|
|- - - - - - @ @ @ - - @ @ @ - - @ - - -|
|- - - - - - - - - - - - - - - - @ - - -|
|- - - - - - - - - - - - - - - - - - - @|
|- @ @ @ - - - - - - - - - - - - - - - @|
|@ @ - - - - - - - - @ @ - - - - - - @ @|
|- - - - - - - - - - @ @ - @ @ - @ @ @ -|
|- - - - @ @ @ - - - - - - @ @ - - - - -|
|- @ @ - - - - - - - - - - - @ @ @ @ - -|
|- @ @ - - - @ @ - - - - - - @ @ @ @ - -|
|- @ - - - - @ @ - - - @ @ @ @ @ - - - -|
|- - - - - - - - - - - - - - - @ - - - -|
|- @ @ @ @ @ @ - - - - - - - @ @ - - - -|
|- - - - - - - - - - - - - - @ @ - - - -|
|- - - - @ @ - - - - - - - - - @ @ - @ -|
|- - - @ @ @ - - - @ @ - - - - - @ @ @ -|
|@ @ - @ @ - - - - @ @ - - - - - @ @ @ -|
|@ @ - - - - - @ - - @ - - - - - - - - -|
|@ @ - - - - - @ - - - - @ @ - - - - - -|
|@ @ - - - - - @ @ @ @ @ @ @ - - - - @ -|
|- - - - - - - - - - - - - - - - @ @ @ -|
|- - - - - - - @ - - - - - - - - - - @ -|
|- - - - - - - @ @ @ @ - - - - - - - @ -|
|- - - - @ @ @ @ @ @ - - - - - - - - - -|
|- - - - - - - - - - - - - - - - - - - -|
|- - - - - - - - - - - @ @ @ - - - - - -|
|- - - - - - - - - - - - - - - - - - @ @|
|- @ - - - @ - - - - - - - - - - - - @ @|
|- @ - - - @ - - - - - - - - - - - - - -|
|- @ @ - - @ - @ @ @ @ @ - - - - - - - -|
|@ @ @ - - @ @ @ @ @ - @ @ - @ - - - - -|
|@ @ - - - - - - - - - - @ - @ - - - - -|
|- - - - - - - - - - - - @ - @ - @ @ @ -|
|- - - - - - - - - - - - @ @ @ - - - - -|
|- - - - - - - - - - - - - @ @ - - - - -|
|- @ @ @ - - - - - - - - - - - - - - - -|
|- - @ @ @ - - - - - - - - - - - - - - -|
|- @ @ @ @ @ @ - - @ @ @ - - - - - - @ @|
|- - - - @ @ - - - - - - - - - - - - - -|
|- - - @ @ @ - - - - @ - - - @ @ - - - -|
|- @ @ @ - - - - - - @ - - - @ @ - @ @ @|
|- - - - - - - @ @ @ @ - - - - - - - - -|
|- - - - - - - @ @ - - - - - - - - - - -|
|- - - - - - - @ @ - @ @ @ - - - - @ @ -|
|- - - - - - - - - - - - - - - - - @ @ -|
|- - - - - - - - - - - - - - - - - - - -|
|- - - - - - - - - - - - - - - - - - - -|
|- - - - - - - - - - - - - @ @ @ - - - -|
|- - - - - - - - - - - - - - - - - - - -|
|- - @ @ - - - - - - @ @ @ - - - - - - -|
|@ @ @ @ - @ @ @ - - - - - - - - - - - -|
|- - - - - - - @ @ @ - - - - - - - - - -|
|- - - - - - - @ @ @ - @ @ - - - - - - -|
|- - - - - - - - - - - @ @ - - - - - - -|
|- - @ @ - - - - - - - - - - - - - - - -|
|- - @ @ - - - - - @ @ - - - - - - @ @ -|
|- - - @ @ - - @ @ @ @ - - @ @ - - @ @ -|
|- - - - @ - - - - - - - - @ @ @ @ @ - -|
|- - - - @ - - - - - - - - - - - - - - -|
|- - - - - - - - - - - - - - - - - - - @|
|- - @ @ @ - - - - - - - - - - - - - - @|
|- - - - - - - - - - - - - - - - - - - -|
|- @ - - - - - - - - - @ @ - - - - - - -|
|- @ - - - - - - - - - @ @ @ - - - - - -|
|@ @ - - - - - - - - - - - - - - - - - -|
|@ - - - - - - - - - - - - - - - - - - -|
|@ - - - - - - - - - - @ @ - - - - - - -|
|@ @ - - - - - - - - - @ @ @ - - - - - -|
|@ @ - - - - - - - - - - - - - - - - - -|
|@ @ - - - @ @ - - - - - - - - - - - - -|
|@ @ @ @ - @ @ - - - - - - - - - - - - -|
