20 200
|- - - - - @ @ @ @ - - - - - @ @ @ - - -|
|@ @ @ - - @ @ @ @ - - - - - @ @ @ - - -|
|- @ @ @ - @ @ @ @ @ - - @ @ @ - @ @ - -|
|@ @ @ @ - - - @ - @ - - - @ @ @ @ @ @ -|
|@ - - @ - - - - - @ @ - @ @ @ - - @ @ -|
|@ - - - - - - - - - @ @ @ @ @ - - @ @ -|
|@ - @ - @ @ - - - - @ @ @ - - - - - @ @|
|@ - @ - @ @ - - - - @ - @ @ @ - @ - - @|
|@ - @ - - - - - @ @ @ - - @ @ - @ - - @|
|- - - - - - - - @ @ @ - - - - - @ @ - -|
|- @ - @ @ - - - - @ @ - - - - - @ @ - -|
|- @ - @ @ - - - - @ @ - - @ @ @ @ - - -|
|- @ - - - - - @ @ @ - - @ @ @ @ @ - - -|
|- - - - - - - - - - - - - @ @ @ - - - -|
|- - - - - - - - - - - - - @ @ @ - - - -|
|- - - - - - - - - @ @ - - @ @ @ - - - @|
|@ @ @ - - - - - - @ @ - - - @ @ - @ - @|
|- - - - - - - - - @ @ @ @ @ @ - - @ @ @|
|- - - - - - - @ - @ @ @ @ - @ @ @ @ @ -|
|- @ - - - - @ @ - @ @ - @ - @ @ @ - @ -|
|- @ - - - - @ @ - @ @ - @ - - - - - - -|
|- @ - - - - - - - - - - @ @ - - - - - -|
|@ @ @ @ @ @ - - - - - - - @ @ @ @ - - @|
|@ @ @ @ @ @ - @ @ @ @ - @ @ - - @ @ @ @|
|- @ @ @ - - - - - @ @ - @ - - @ @ @ @ @|
|- @ @ @ @ @ - - - - @ - @ - - @ @ @ @ @|
|- - - @ @ - - @ @ @ @ @ @ - - - - @ @ @|
|- - - - @ @ @ @ @ @ @ - @ @ @ - - - @ @|
|- - - - - - - - - - - - - @ @ - - @ @ @|
|- - - - - - - - @ - - - - - - - - @ - -|
|- - - - @ - - - @ - @ @ - - - - - @ @ @|
|- - - @ @ - - - @ - @ @ - - - - - - @ @|
|- - - @ @ @ @ - - - - - - - - - @ @ @ @|
|- - @ @ - @ @ - - @ - - - - - - @ @ - -|
|- - @ @ - @ @ - - @ - - - - - - - - - -|
|- - @ @ - - - - - @ - - - - - - @ @ - -|
|- - - @ - - @ @ - - - - - - - - @ @ - @|
|- - - @ @ - @ @ - - - - - - - - - - - @|
|@ @ - @ @ - @ - - - - @ @ @ - - - - - -|
|- - - - - - @ - - - - - @ @ @ - - - - -|
|- - - - - - - - - - - - @ @ @ @ - - - -|
|- - - @ - - - @ @ @ - - - - - - - @ @ @|
|- - - @ @ @ - - - @ @ @ - @ @ - - @ - -|
|@ @ - @ - - - - - @ @ @ - @ @ - - @ - -|
|@ @ @ @ - - - - - - - - - @ - - - @ @ -|
|- - @ @ @ @ - - - - - - - @ - - - @ @ -|
|- @ @ @ @ @ - @ @ @ @ - - @ - - - - - -|
|- @ @ @ - - - @ - - - - @ @ - - - - @ @|
|- @ - - - - - @ - - - - @ - - - @ @ @ -|
|- @ @ @ - @ @ @ @ @ - - @ @ @ @ @ @ @ -|
|- - - @ @ @ @ - @ @ @ @ @ - @ @ - @ @ @|
|- - - - - - - - @ @ @ @ - - - - - - - -|
|- - - - - - - @ @ @ @ @ - - - - @ @ - -|
|- - @ - - - @ @ @ @ - - - - - - @ @ - -|
|- - @ - - - @ - @ - - - - - - - - - - -|
|- - @ @ @ @ @ - @ - - - - - - - - - - @|
|- - - - - @ @ @ @ - - @ @ @ - - - - - @|
|- - - - - @ - - - - - - - - - - - @ @ @|
|- @ - - - - - - - - - - - - - - - @ @ -|
|- @ - - @ - - @ - - - - - @ @ - @ @ @ -|
|@ @ - - @ - - @ - - - - @ @ @ @ @ - - -|
|@ - - - @ - - @ - - - - - - @ @ @ @ - -|
|@ @ @ - - - - @ - - - - @ @ @ @ @ @ @ -|
|@ @ - - - - - @ - - - - - - - - - - @ @|
|@ @ - - @ - - @ - - - - - - - - - - @ @|
|@ @ - - @ - - - - - - - - - - - - - - -|
|@ - - - @ - @ - - - - - - - - - - - - -|
|@ - - - - - @ - - - - - - - - - - - - -|
|@ - @ @ - @ @ @ - - - - - - - @ @ - - -|
|- - @ @ - - - @ @ @ @ - - @ @ @ @ - - -|
|- - - - - - @ @ @ - - - - - - @ @ @ - -|
|- - @ @ @ - - - - - - - @ @ @ @ @ @ @ @|
|@ @ @ - @ @ @ @ @ - - - @ @ - - - - - -|
|- - @ - - @ @ - - - - - @ @ - - - - @ @|
|- - @ @ @ @ @ - - - - - - - - @ @ @ @ @|
|- - - - - - - - - - - - - - - - @ - - @|
|- - - @ @ @ @ - @ - @ - - @ @ - @ - - -|
|- - - @ - - - - @ - @ - - @ @ @ @ @ - -|
|- - - @ @ - @ - @ - @ - - @ @ - - - - -|
|- - - @ @ - @ - - - - - - @ @ - - - @ @|
|- - - @ @ - @ @ - - - @ - - - - - - @ @|
|- - - @ @ - - @ - @ @ @ @ @ @ - @ - @ @|
|- - - - - - - @ - @ @ @ @ @ - - @ @ @ -|
|- - - @ - - - @ @ @ @ @ @ @ - - @ @ @ -|
|- - - @ @ @ - - @ @ - - - - - - - - - -|
|- - - @ - @ @ - - - - - - - - @ @ @ - -|
|- - - @ @ @ @ - @ @ @ @ @ - @ @ @ @ - @|
|- - - @ @ @ - - - - - - @ @ @ - @ @ - @|
|- - - @ @ - - - - - - - @ @ @ - @ @ - @|
|- - - @ - - @ @ @ - - - - @ @ @ @ - - -|
|- - - @ - - - - @ - - - - - - @ - - @ -|
|- - - - - - - - @ @ @ - - @ @ @ - - @ -|
|- - - - - - - - @ @ @ - @ @ @ - - - @ -|
|- @ @ @ - - - - @ @ @ @ @ @ - - - @ @ -|
|@ @ - - - - - - - @ @ @ - - - - - @ - -|
|- - - - @ @ @ - @ @ @ - - @ @ @ - @ - -|
|- - - - - - - - @ @ @ - - - @ @ @ @ - -|
|- @ @ @ - @ @ - - - - - - @ @ @ - @ - -|
|- - - - - @ @ - - - - - - - - - - @ - -|
|- - - - - @ - - - - - - - - - - - @ @ -|
|- @ @ @ - @ - - - - - - - - - - - @ @ @|
|- @ @ @ @ @ @ - - - - - - - - - - - @ @|
|- @ @ - - - @ @ - - - @ @ @ - - @ - - @|
|- @ @ - @ - @ @ - - - @ @ @ - - @ - - @|
|- - @ - @ - - @ - - - - - @ - - @ - - -|
|- - - - @ - - @ - - - - - - - - @ - @ @|
|- - - - @ - - @ - @ @ @ @ @ - @ @ - - @|
|- - - - @ - - @ @ @ - - - @ - @ - - - @|
|@ @ - @ @ - @ @ @ @ - - - @ @ @ - - - @|
|@ @ - @ @ - @ - @ @ - - - @ @ @ - - - -|
|- @ @ @ - - @ - @ @ - - - - - - - - - -|
|@ @ @ @ - @ @ - - @ @ @ - - - - - - - -|
|@ - - - - @ @ - - - - - - - @ @ @ @ @ @|
|@ @ @ @ - - - - - - - @ @ - - - @ @ @ @|
|- - - - - - - - - - - @ @ @ - - @ @ - -|
|- - - - - - - - - - - - - @ - - - - - -|
|@ @ - - - @ - @ @ @ - - - @ - - @ - @ -|
|- - - - - @ - - - @ @ - @ @ - - @ @ @ -|
|@ @ - - @ @ @ - - @ @ - @ @ - @ @ @ @ @|
|- - - - - - - - - @ @ - - - - @ - - @ @|
|- - - - - - - - - @ @ - - - - @ - @ @ @|
|- - - - - - @ @ - @ @ - - - @ @ - - @ -|
|- - - - - - @ @ @ @ @ @ - - @ - - - @ -|
|@ @ - - - - - - @ - - - - - @ - - @ @ -|
|@ - - - - - @ @ @ @ - - - - @ @ @ @ @ -|
|@ - - @ @ - @ @ @ @ @ @ @ - - @ - - - -|
|@ - - @ @ - @ @ - - - - - - - @ @ @ - -|
|- - - - - - @ - - - - - - - @ @ @ @ - -|
|- - - - - @ @ @ - - - - - - @ @ @ @ - -|
|- - - - - @ - @ - @ @ - - - - @ @ @ - -|
|- - @ @ @ @ - @ - @ @ - @ @ @ @ - - - -|
|- - @ @ - - - - - - - - @ @ - - - - - -|
|- - @ @ @ @ - @ @ @ @ - - @ - - - - - -|
|- - @ @ - @ @ @ - - - - - @ - - - - - -|
|- - - @ - - @ @ - - - - - @ @ - - - @ -|
|- - @ @ - - @ @ - - @ - - @ @ @ @ @ @ -|
|- @ @ @ - - @ @ - - @ - @ @ @ - - - @ -|
|- - - @ - @ @ - - - @ - - @ - - - - - -|
|- - - @ - @ - - @ @ @ - - @ - - - - - -|
|- - - @ - @ - - @ @ - - - - - - - - - -|
|- - - - - - - - @ @ - - - - - - - - - -|
|- - - - - - - - - - - - - @ - - - - - -|
|- @ @ @ - - @ - - - - - - @ - - - - - -|
|- - @ - - @ @ - - @ @ @ - @ @ - @ - - -|
|- - @ @ @ @ @ - - - - @ - @ @ - @ - - -|
|- - - @ @ @ @ @ - @ - @ - @ @ @ @ - - -|
|- - - - - - @ @ - @ - @ @ @ @ @ @ - - -|
|@ @ - - - - - @ - @ - @ @ @ - - - - - -|
|@ @ - - - - - @ - @ @ @ - - - - @ - - -|
|@ @ - - - - - @ @ @ @ @ - - - - @ - @ @|
|@ - - @ @ - - - @ - - @ @ - - - @ - @ @|
|@ - - @ @ - - - @ - - - @ @ @ - - - @ @|
|@ - - @ @ - - - @ @ - - - - - - - - @ -|
|- - - - @ @ @ - - @ - - @ @ @ @ @ @ @ @|
|- - - - @ @ @ @ @ @ - - @ @ @ @ @ @ @ -|
|- @ @ - - - @ @ @ - - - - - - @ - @ @ -|
|- @ @ @ @ @ @ - - - - - @ @ @ @ - @ - -|
|- - - @ @ @ - - @ - - - @ - - - - @ @ @|
|- - - - @ @ - - @ - - - @ - - - @ @ @ -|
|- - @ @ @ @ - - @ - - - @ - - - @ - - -|
|- - - - - @ @ - - - - - - - - - @ - - -|
|- - - - @ @ @ @ @ - @ - - - - - @ @ - -|
|- - - @ @ @ @ @ @ - @ @ @ - - - - @ - -|
|- - - @ - - - - @ @ @ - @ @ @ - - @ - -|
|@ @ @ @ @ @ @ - - @ - - @ @ @ - - - - -|
|- - - @ - @ @ @ @ @ - - - @ @ - - - - -|
|@ @ - - - - @ @ @ @ - - - - @ - @ @ @ -|
|- - - - - - @ @ @ @ @ @ - - @ - @ @ @ -|
|@ - - - - - - - - @ @ @ - - @ - - @ @ @|
|@ - - - - @ @ @ @ @ @ @ - @ @ @ @ @ - @|
|@ - - - - @ @ @ - - - @ - @ - - @ @ @ @|
|- - - - - - - @ @ @ @ @ - @ - @ @ @ @ -|
|- @ - - - - - @ @ @ - @ @ @ @ @ - @ @ @|
|@ @ - - - @ @ @ - - - @ - @ @ @ @ @ - -|
|@ @ - - - - - @ @ @ @ @ - @ @ @ - - - -|
|@ - - - - - - @ @ @ @ @ - - - - - - - -|
|@ @ @ @ - - - @ - @ @ @ - - - - - - - @|
|- - - - - - - @ - @ @ @ - - - - @ - @ @|
|- - @ @ @ - - - - @ @ - - - - @ @ - @ @|
|- - - - - - - - - - @ - - - - @ @ - @ -|
|- @ @ @ @ @ @ - - - - - - - - - - - - -|
|- @ @ - - - - - @ @ @ - - - - - - - - -|
|- - - - - @ @ - @ @ @ - - @ - @ @ - - -|
|- - - - - @ @ - @ - - - - @ - @ @ - - @|
|- - - @ @ @ @ @ @ @ @ - @ @ - - - - - @|
|- - - - - - - - - - - - @ @ @ @ - - - @|
|- - - - - @ @ @ - - - - - - - - - - @ @|
|- - - - - - - - - - @ @ @ - - - - - @ @|
|- - - @ @ @ @ @ @ @ @ @ - - - - - - - -|
|- - - - - - - @ @ @ @ - - - @ @ - - - -|
|- - - - - - - @ - - - - - @ @ @ - - - -|
|- - - - - - - @ - - @ - @ @ @ @ @ - - -|
|- - - @ @ @ - @ @ @ @ - @ @ @ @ @ - - -|
|- - @ @ @ - - - @ @ @ - @ @ @ @ @ @ - -|
|- - @ @ - - - - - @ @ @ @ @ @ @ - - - -|
|@ - @ @ - - - - @ @ @ - @ @ @ @ - @ @ @|
|@ @ @ @ @ @ - - @ @ - - - @ @ - - - - -|
|@ @ @ - - - - - @ @ @ @ - - - - - - @ @|
|- - @ - - - - - - - @ @ @ - - - - - - -|
|- - - - - - @ @ @ - @ @ @ @ - @ @ - - -|
