20 200
|@ - - - - - - - - @ @ @ - - - - - - @ @|
|@ - - - - - - @ @ @ @ - - - - @ @ - @ @|
|@ - - - - - - @ @ - @ - @ @ @ @ @ - - -|
|- - - - - @ @ @ @ - - - - - - @ @ @ @ @|
|- - - - @ @ @ @ @ - - - - - - - - - - -|
|- - - - - - - @ @ @ @ @ - - - @ @ @ - -|
|- @ - @ @ @ @ @ - - - - - @ @ @ @ - - @|
|- @ - - - - @ - - - - - - @ - @ @ - - @|
|- @ - - - - @ - @ @ @ - - @ @ @ @ - - -|
|- @ @ @ - @ @ - @ @ @ - - - @ - - - - -|
|- @ - @ @ @ @ - @ @ @ @ @ - @ - - - - -|
|- @ - @ @ @ @ - @ @ - - - - @ @ @ - - -|
|- @ @ @ @ - - - - @ - - - - - @ - - - -|
|- @ @ @ - - - - - @ - - - - - @ - - - -|
|- - - @ - - @ @ @ @ - - - - - @ - @ - -|
|- @ @ @ - - - - @ @ @ - - - - - - @ @ @|
|- @ @ @ - - - - - - @ @ @ @ @ @ - @ - -|
|- - - - - - @ @ - - @ - - @ @ @ @ @ - -|
|- - - - - - @ @ - - - - - @ @ @ @ @ - -|
|- - - - - @ @ - - - - - - - - @ @ - - -|
|- - - - - @ - - - - - @ @ - - @ @ - - @|
|- - - - - @ - - - - - @ @ - - - - - @ @|
|- - - - - - - - - - - - - - - - - @ @ -|
|- - - - - - - - - - @ @ @ - - - - @ @ -|
|- - - - - - - - - - - - - - - - @ @ - -|
|- - - - - - - - - - - - - @ - @ @ @ - @|
|- - - - - - - - - @ @ @ @ @ - @ @ @ - @|
|- - - - - - - - - @ - - - @ - @ @ @ - @|
|- @ @ @ @ @ @ @ @ @ - @ @ @ - @ @ @ - @|
|- @ @ @ @ @ @ - @ - - - @ - - @ @ @ @ @|
|- @ - - - @ @ @ @ @ @ @ @ - - @ @ - - @|
|- @ @ @ - - - - @ - - - @ - - @ @ - - @|
|- - - @ @ @ - - - - @ @ @ - @ @ @ @ - -|
|- - - @ - - - - - @ @ @ @ - @ @ - @ - -|
|- - - @ - - - - @ @ - - - - @ @ - @ @ -|
|- - - @ - - - - @ - - - - @ @ @ @ @ @ -|
|- - - @ @ @ @ - @ - - - - @ - @ @ - @ @|
|- - - @ @ - @ - - - - - - @ - @ @ - @ @|
|- - @ @ @ - @ - - - - - - @ - @ - - @ @|
|- - @ @ @ - @ - - - - @ @ @ - @ - - @ @|
|- - @ - - - - - - - - @ @ @ @ @ - - - -|
|- - @ - - - - - @ - - @ @ @ - - - - - -|
|- - @ @ @ - - - @ - - @ @ @ - - @ @ @ -|
|- @ @ @ @ - - - @ - - - - - - - - - - -|
|- @ @ @ @ @ @ - @ @ - @ @ @ - - - - - -|
|@ @ - @ @ - - - - @ @ @ @ @ - - - - - -|
|- @ @ @ - - - - - @ @ @ @ @ - @ @ @ - -|
|@ @ @ - - @ @ - - @ - @ @ - - - - - - @|
|@ @ @ @ @ @ @ - - - - - - - - - - - - @|
|- - - - @ @ - - - - - - - - - @ @ @ - @|
|@ @ @ - - - - - - - - - - - - @ @ - - @|
|- - - - - - @ @ @ - - - - - - - - - - -|
|@ - @ @ @ - - @ @ - - - - - @ @ @ @ @ -|
|@ - - - - - - @ @ @ - - - @ @ - - - @ -|
|@ - - - @ @ - - - @ @ - - @ @ - @ @ @ -|
|- - - - @ @ - - - @ @ @ @ @ - - @ @ - -|
|- - - - - - - - - @ @ - - - - - @ @ @ @|
|- - - - - - - - @ @ - - @ - @ @ @ - - -|
|- - - - - - @ @ @ @ - - @ - @ @ - - - -|
|- - - - @ @ @ @ - - - - @ - @ @ - @ @ @|
|- - - - @ @ - - - - - - - - - - - - - -|
|- - @ @ @ @ - - @ @ @ - - - @ @ - - @ @|
|@ @ @ - @ @ @ - @ @ @ - - - @ @ - - @ @|
|- - @ - - - @ - - - - - @ @ @ @ - - - @|
|- - @ @ @ @ @ - @ @ @ - - - - - - - - -|
|- - @ - - - - - - - - - - - - @ @ @ @ @|
|- - @ - - - @ @ - - - - - - - @ @ - - -|
|- - - - - - @ @ @ - - - - - - - - - - -|
|- - - - - - @ @ @ - - - - - - - - @ @ @|
|- - - - - @ @ @ @ - - - - - - - - - - -|
|- @ @ - - - - - - - @ @ @ - - - - - - @|
|- @ @ - - - - - - - @ - - - - - - - - @|
|- - - - - - - - - @ @ @ - - @ @ - - - @|
|@ @ @ @ - - - - - @ @ @ - @ @ @ @ @ - @|
|- - @ @ - - - - - - - @ - @ - - @ @ - -|
|@ @ @ - - - @ @ - - - - - @ - - @ @ @ -|
|- - - - - - @ @ - - - - - @ @ @ @ @ @ -|
|- - - - - - @ - - - - - - @ @ - @ - - -|
|- @ @ @ - - @ @ @ @ - - - @ @ @ @ @ - -|
|@ @ @ @ - - @ @ @ @ - - - - @ - - @ - -|
|@ @ @ @ - - @ @ @ - - @ - - @ - - @ - -|
|@ - @ @ @ @ @ - @ - - @ @ @ @ - - @ - -|
|@ @ @ - @ @ - - @ @ @ @ - - @ @ - @ - -|
|@ @ - - - - - - @ @ @ - - - @ @ - - - -|
|- - - - @ - - - - - - - - - - - - - - -|
|@ @ - - @ - - - - @ @ - - - - - - - - -|
|- - - - @ @ @ - - @ @ @ @ @ @ - - - @ @|
|- - - - - @ @ - - @ @ - - - @ @ @ - - -|
|- - - - - @ - - - @ @ - @ @ @ - @ - - -|
|- - - - - @ - - @ @ @ - @ @ - - @ - - -|
|- - - @ - - - - @ @ @ @ @ - - - - - @ @|
|@ @ - @ - - - - - - @ - - - - - - - - -|
|- - - @ - - - - - - - - - - @ @ - @ @ -|
|- - - - - - - @ - - - - - - @ @ @ @ @ -|
|- @ @ - - - - @ - - - - - - @ - @ - - -|
|- @ @ @ @ @ - @ - - - @ @ @ @ @ @ - - -|
|@ @ @ @ @ @ - @ @ @ - @ @ - - - @ @ @ -|
|@ @ - @ - @ - - - @ @ @ - - - - - @ @ -|
|@ - - @ - - - - - - - - - - @ - - @ @ @|
|@ @ - @ - - - - - - - @ @ - @ @ @ @ @ -|
|@ @ @ @ - - - - - - - @ @ @ @ - - @ @ @|
|@ @ - - - - @ @ @ @ @ @ @ - - - - @ @ @|
|- - - - - - @ - - - @ - - - - - - - - -|
|- - - - - - @ - - - @ @ - - - - @ @ @ -|
|@ - - - - - @ @ - @ @ @ - - - - - - - -|
|@ - @ @ @ - @ @ - @ @ @ - - - @ @ @ @ @|
|@ @ @ - - - - - - - - - - @ @ @ @ - - @|
|- @ @ - @ - - @ @ @ - - - - - - @ - - @|
|- - - - @ - - - @ @ - @ - - - - @ - - -|
|- @ - - @ @ @ @ @ @ - @ - - - @ @ - - -|
|- @ - - - - - - @ @ @ @ - @ - @ @ @ - -|
|@ @ @ @ - - @ @ @ @ @ - - @ @ @ @ @ - -|
|- - @ @ - - @ @ @ @ @ @ @ @ @ - - - - -|
|- - - - - - - @ @ @ - - @ @ @ @ @ @ - -|
|- - - - - - - @ @ @ - - @ @ - @ @ @ - @|
|- - - - - - - - - - - - - - - - - @ @ @|
|- - - - - - - - - - - - - - - - - - @ -|
|- - - - - - - - - - @ - - @ @ @ @ @ @ -|
|- - - - - @ @ - - - @ - - - - - - - @ -|
|- - - @ - @ @ - - - @ - - - - - - - - -|
|- - - @ - @ @ @ @ @ @ - - - - - @ @ @ @|
|- - - @ - - - @ @ @ @ - - - - - - - - -|
|- - - - - @ @ @ - - - - - - - - - - - -|
|- - @ - - - @ @ @ - - @ - - - - - @ - -|
|- - @ - - @ @ - - - - @ - - - - - @ @ @|
|@ @ @ - - @ @ - - - - @ - @ @ @ @ @ - @|
|- - - - - @ @ - - - - @ @ @ - @ @ @ - @|
|- @ - - - @ @ - - - - - @ @ @ @ @ @ - -|
|- @ - - - - - - - - - - - @ @ - - @ @ @|
|- @ - - - @ @ @ - - - - - @ @ @ - @ - -|
|- - - @ @ @ @ - - - - @ @ @ @ @ @ @ - -|
|- - - @ @ @ @ - - - - @ @ - - @ @ @ - -|
|- - - - @ @ @ - - @ - - - - - - @ @ @ -|
|@ @ - - @ @ - - - @ - - @ @ @ - @ @ @ -|
|@ @ @ @ @ - - - - @ - - - - @ @ @ @ @ -|
|- @ @ @ @ @ - - @ @ @ - - - - - @ - - -|
|- @ - - @ @ - - @ @ @ - - - - @ @ @ @ @|
|- @ - - @ - - - @ @ @ @ @ - - @ @ - - -|
|@ @ - - @ - - @ @ - - - - - - @ - - @ @|
|- - - @ @ @ - @ @ @ - - @ @ @ @ - - - -|
|- - - - - - - @ @ @ - - - - @ @ - - - -|
|- - @ - - - - - @ @ @ @ @ - @ @ - - - -|
|- - @ - - - - - @ - @ @ - - - - - - - @|
|- - @ - - @ @ @ @ - - - - - - - - - - @|
|- - - - - - - - @ @ - - - - - - - - - @|
|@ @ - - - - - - @ @ - - - - - @ @ - - -|
|@ - - - - - - - - @ @ @ - - - @ @ - - @|
|@ - @ @ @ @ - - - @ - - - - - - @ - - @|
|@ - @ @ - - - @ @ @ - @ @ @ - - - - @ @|
|@ - - - - - @ @ @ @ @ @ @ - - @ @ @ @ @|
|@ @ @ @ @ @ @ @ - - - - @ @ - - - @ @ @|
|@ @ @ @ - @ @ @ @ - - - - @ @ - - - @ @|
|@ @ - @ @ @ - @ - - - - - @ @ - - - - -|
|- - - @ @ - - @ - - - - @ @ @ - - - - @|
|- - - @ @ - - @ @ @ @ @ @ @ @ @ @ @ @ @|
|- - - @ @ @ - - - @ - - - @ @ - - - @ @|
|- - - - - @ @ @ @ @ - - - @ @ - - @ @ -|
|@ @ @ - - - @ @ @ @ - - @ @ @ - @ @ - -|
|- - - - - - @ @ - @ @ - - - - - @ @ - -|
|- - - - - - @ - - @ @ - - @ @ @ @ @ - -|
|@ @ - - - - - - - - @ - - @ @ - - @ @ -|
|@ @ @ - - - - @ @ - - - - - - - - @ @ @|
|@ - @ - - - - @ @ - - - - - - @ @ @ @ @|
|@ @ @ @ - - - @ @ @ @ - - - - @ @ - - @|
|@ @ @ @ - - @ @ @ - - - - - - - - - - -|
|@ @ @ - - - - @ @ - - - - @ @ - - - @ @|
|@ @ @ - - - - @ @ @ @ @ @ @ @ @ - - - -|
|- @ - - - - - @ @ - - - - - - @ @ @ @ -|
|@ @ - - - - - - @ - - - - - - @ - - @ -|
|- @ - - - - - - @ @ @ - - - @ @ - - @ -|
|@ @ - - - - - - - @ @ - - - @ @ @ @ @ -|
|@ @ @ - - - - - - - @ - - - @ - @ @ - -|
|- - @ - - - - - - - - - - - @ @ @ - - -|
|- - @ - - - - @ @ @ @ - - - @ @ @ @ @ -|
|- - @ - - - - @ @ - @ @ - - - - - @ @ -|
|- - - - - - - - - - @ @ @ @ - - - @ @ -|
|- @ @ - @ @ @ @ - - - @ @ @ - - - @ @ -|
|- @ @ - @ - @ @ @ @ @ @ @ - - - - - - -|
|- - - - @ @ @ @ - - @ @ - - - - - @ @ @|
|- - - - - - - @ @ @ @ - - @ @ @ @ @ @ @|
|@ @ @ - - - - - @ @ @ - - @ - - @ @ @ @|
|@ - - - - - - - @ @ @ @ - @ - - - - @ @|
|@ - - - - - - - - @ - - - - - - - - - -|
|@ @ @ - - - - @ @ @ - - - - - - - - - -|
|@ @ @ @ - - - @ @ - - - - - - @ @ - - -|
|@ @ @ @ - - - - @ @ - - - - - @ @ - - @|
|@ - - @ - - - - @ @ - - - - - - - - - @|
|@ - - - - - @ - @ @ @ @ @ @ @ @ @ @ - -|
|- - @ @ @ @ @ - - @ - - - - - @ @ @ @ -|
|@ - @ @ - - @ - - @ - - - - - @ @ @ @ @|
|@ - - - - @ @ - - @ @ @ - - - - - - - -|
|@ - @ @ @ @ @ @ @ @ - - - - - - - - - -|
|- - @ @ @ - @ @ @ - - @ @ - - - - - - -|
|- - @ @ @ - - - @ - - @ @ - - - - - - -|
|- - @ @ @ @ - - - - @ @ @ - - - - - @ @|
|- - @ @ - @ @ @ @ - @ @ - - - - - - @ @|
|- - - - - @ @ @ - - - - - - - - @ @ @ @|
|- - @ @ - - - - - - - - - - - - @ @ @ -|
|- - @ @ - - @ @ @ - - - @ @ - - - - @ -|
|- - - - - - - - - - - - @ @ - - - - @ -|
