30 30
|- - - - - - - - - - - - - - @ - - - - - - - - - - - - - - -|
|- - - - - - - - - - - - - - @ - - - - - @ - - - - - - - - -|
|- - - @ @ @ - - - - - - - - @ - - - - - @ - - - - - - - - -|
|- - - - - - - - - - - - - - - - - - - - @ - - - - - - - - -|
|- - - @ @ - - - - - - - - - - - - - - - - - - - - - - - - -|
|- - - @ @ - @ @ @ @ - - @ @ @ - - - - - - - - - - - - - - -|
|- - - - @ @ @ - - - - - - - @ @ - - - - - - - - - - - @ @ @|
|- - - - - - @ @ @ - - - - - @ @ - - - - - - - - - - @ @ - -|
|- - - - - - - - - - - - - - - - - @ @ @ - - - - - - @ @ - -|
|- - - - - - - - - - - - - - - - - - - - - - - - - - - - - -|
|@ - - - @ @ @ - - - - - @ @ @ @ @ @ - - - - - - - - - - - -|
|@ - - - - - - - - - - - - - - - - - - - - - - - - - - @ - -|
|@ @ - - - - - - @ @ @ - - - - - - - @ @ @ @ - - - @ - @ - -|
|- @ - - - - - - - - - - - - - - - - - - @ @ - - - @ - @ - -|
|- @ @ - - - - - - - - - - - - - - - - - - - - - - @ - - - -|
|- - @ - - - - - - - - - - - - - - - @ @ @ @ - - - @ - - - -|
|- - @ @ - - - - - - - - - - - - - - - - - @ @ @ - @ @ @ - -|
|- - - @ - - - - - - - - - - - - - - - @ @ @ @ @ - @ @ @ @ -|
|- - - @ - - - - - - - - - - - - - @ - @ @ @ @ - - - - - - -|
|- - - @ - @ - - - - - - - - - - - @ - @ @ @ - - @ @ - - - -|
|- - - - - @ - - - - @ @ @ - - @ - @ - - - - - - @ @ - - - @|
|- - - - @ @ - - - - - - @ @ - @ - - - - - @ @ - - - - - - @|
|- - @ @ @ - - - - - - - - @ - @ - - - - - @ @ - - - - - - @|
|- - - - - - - - - - - - - @ - - - - - - - - - - - - - - - -|
|- - @ - - @ - - - - - - - - - - - - - - - - - - - - - - - -|
|- - @ - - @ - - - - - - - - - - - - - - - - - - - - - - - -|
|- @ @ - - @ - - - - - - - - @ @ @ @ - - - - - - - - - - - -|
|- @ - - - - - - - - - - - - - - - @ - - - - - - - - @ @ @ -|
|- @ - - - - - - - - - - - - - - - @ - - - - - - - - - - @ -|
|- - - - - - - - - - - - - - - - - - - - - - - - - - - - @ -|
