100 50
|- - - - - - - - - - @ - - - - - - - - @ - - @ - - - - - - - - @ @ @ - - - - @ - - - - - @ @ - @ @ @ @ @ - @ @ @ - - @ @ - - @ @ - @ @ @ @ - - - - - - - - @ @ - - - - - @ - - - - @ @ @ @ @ @ - - - - -|
|- - - - - @ @ @ - - @ - - - - - - @ - @ @ @ @ - - - - - - - - - - - - - @ - @ - @ @ - - @ @ - - - - - @ @ @ @ @ @ - @ @ @ - @ @ - - - @ @ - - - @ @ @ - - @ @ - - - - - @ - - - - - - - @ @ @ @ @ - - -|
|@ @ - - - @ @ @ - @ @ - - - - - - @ - - @ @ @ - @ @ @ @ @ @ - - - @ @ @ @ - @ - @ @ @ - - @ - - - - - - - - - @ @ - - - @ - - @ - - - - - - - - - @ @ - @ @ @ - - - - - @ @ @ - - - - - - - @ @ @ @ - -|
|@ - - - - @ @ @ - @ - - - - @ - - @ @ - - - @ @ @ @ @ @ - @ - - - - - @ @ - - - - - @ @ @ @ - - @ @ - @ @ - - - - - - - @ - - @ - @ - - - - - - - @ @ @ @ - - - - - - - - - - - - - - - @ @ @ @ @ @ @ @|
|@ - - - - - - @ @ @ - - - - @ - - @ @ - @ @ @ @ - - - - - @ - - - - - @ @ - @ @ @ - @ @ @ @ - - @ @ - @ @ - - - - - @ @ @ @ - @ @ @ - - - - - - - @ @ - - - - @ @ - - - @ @ @ @ - @ @ - @ @ - - @ @ @ @|
|- - @ @ - - - @ @ @ - @ - - @ - - @ @ - @ - - @ - - - - - @ - - - - - - @ @ @ @ - - - @ - - - - - - - - - - - - - - - - - - - @ @ @ - - - - - - - @ @ - - @ @ @ @ @ - - - - @ @ @ @ @ - @ @ - - @ @ - -|
|@ @ @ @ - - - - - - - @ - - @ - - @ - - @ - - @ @ - - - - @ @ @ - - @ @ @ @ - @ @ - - - - - @ @ - - - - - - - - - - - - - - - - - @ - - - - - - - @ @ - - - - - @ @ - - - - - @ @ - - - - - - - - - - -|
|@ @ @ - - - - - - - - @ - - @ @ - @ - - @ - - @ @ - - - - - - @ @ @ @ - - @ - @ @ @ @ @ - - @ @ - - - - - - - - - - - - - - - - - @ - - - - - - - - - - - - - @ @ @ - - - @ @ @ - - - - - - - - - @ @ @|
|- - - - - - - - - - - - - - - @ - @ - - @ - - - - - - - - @ - - @ @ - - - @ - - - - - - - - @ @ @ - - - - - @ @ - - - @ @ - - - - @ @ @ - @ @ - - - @ - @ @ - @ @ - - - @ @ @ @ @ - - - @ - - - - - - -|
|- - - @ - - @ - - @ - - - - - @ - - - - - - - - - - - - - @ @ @ @ @ - - - @ - - - - @ @ @ - @ - @ - - - - - @ @ - - - @ @ - @ - - @ @ @ @ @ @ - - - @ - @ @ - - @ - - - - - @ @ @ - - - @ - - - - @ @ @|
|@ @ @ @ - - @ - - @ @ - - - - @ @ @ - @ - - @ @ - - - - - @ - - - @ @ @ @ @ - @ @ - - - - - @ - @ - - - - - - @ - - - - - - @ - - - @ @ @ - @ - - - @ @ @ @ - - - - - - - - - - @ - - - @ - - - - - - @|
|@ @ @ @ - @ @ @ @ @ @ - @ @ - - - - - @ - - @ @ - - - - - - - - - @ @ @ @ @ - @ @ @ @ - @ @ @ @ @ - - @ @ - - @ - - - - - - @ - @ - @ @ @ - - - @ - - @ @ @ @ - - @ @ - - - - - @ @ @ @ @ - - - @ - - @|
|- - - @ - @ - - - - @ - @ @ - - - - @ @ @ @ @ - - - - - - @ @ @ @ @ - - - - - - - @ @ - @ @ @ @ @ @ - @ @ - @ @ @ @ - - - - @ - @ - - - @ - - - @ - - - - @ @ - - @ @ @ @ @ - - - @ @ @ - - @ @ @ - - -|
|- - - @ - @ @ - - - - - - - - - - @ @ - @ @ - - - @ @ @ @ @ @ - - - - - - - - @ @ @ @ @ @ - - - @ @ - @ - - @ @ - - - - @ - @ @ @ - - - @ @ - @ @ - - - @ @ @ - - - - - - - - - - - - @ - - - - @ - - @|
|- - @ @ @ @ @ @ - - - - - - - - - @ @ - @ @ - - - @ @ @ @ - @ @ @ - - - - - - @ @ - - @ @ @ @ - - @ - - - - - - - - - - @ - - @ @ - - - - @ - @ - - - - - - @ - - - - - - - - - - - - @ @ @ - - @ @ - @|
|- - - - @ @ @ @ - - - - @ @ @ - - @ - - @ - - - - @ @ @ @ - - - - - - - - - @ @ @ @ - @ @ @ @ - - - - - - @ @ - - - - - @ - - - - - - - - @ - @ - - @ @ @ @ @ @ @ @ - - - - - - - - - - - - - @ @ @ - @|
|- @ @ @ @ @ @ @ - - - - - @ @ @ - @ - - - - @ - - - - @ @ - - - @ @ @ - - - - - - @ @ @ @ - - - @ - - - - @ @ - - - - - - - - - - - - - - @ - @ @ - @ @ - - - - - @ - - - - - - - - - @ @ @ @ @ - @ - -|
|- - - - - - @ - - - @ @ @ @ @ @ - @ @ @ @ - @ - - - - - @ - - - - - - - - - - - - - - @ @ @ @ @ @ @ - - - - @ @ - @ @ @ @ @ @ - - - - @ @ @ - @ @ - - - - - - - - @ - @ @ @ - @ @ @ - @ @ @ @ @ - @ - -|
|- - - - @ - @ @ @ @ @ - - @ @ @ - - - @ @ - @ - - @ @ - - - - - @ @ @ - - @ @ @ - - - - - - - - @ @ - - - - @ @ - @ @ - - - - - - - - - - - - - - - @ @ @ @ - - @ @ - - - - - @ @ @ @ @ @ - @ @ - @ - -|
|@ @ @ - @ - - - - - @ - - @ @ - - - - @ - - - - - @ @ - @ @ @ - - - @ @ - - @ - - - @ @ @ - - - - @ - @ - - - - - @ @ @ @ - - - - - - - @ @ @ - - - - - - @ - - @ @ - - - @ @ @ @ @ - - @ - - - - - - @|
|- @ - - @ @ @ - - - - - @ @ @ @ @ @ @ @ - @ @ - - - @ - @ - - - - - @ @ - - @ - - - @ @ @ @ - - - @ @ @ - - - - - @ @ - - - - - - - - - - - @ @ @ @ @ - - @ - - @ @ - - - @ @ @ @ - - @ @ @ - - - @ @ @|
|- @ - - @ @ @ - - - - @ @ - - - - @ @ - - @ @ @ @ @ @ - @ - - - - - - - - - @ - - - @ @ @ @ @ @ - - - @ - - - - - @ @ - - - - - - - - - - - - @ @ @ - - - - - - @ @ @ @ @ @ @ - @ @ @ @ @ @ @ @ - - - -|
|- - - - - - @ @ - - @ @ @ - - - - - - - - @ - - - @ - - @ @ @ @ - - - - - - @ @ - - - - - - @ @ - - - - - - - - @ @ @ @ - - - - - - - @ - - - @ @ @ - - - - - - - @ @ - - - - - @ @ @ @ @ - @ @ - - - -|
|@ @ @ @ - - - @ @ @ @ @ @ - - - - - @ - - @ @ @ @ @ - - - - @ - - - - - - - @ @ - - @ @ - - - - - - - - - - - - - @ - - - - @ @ @ - - @ - - - - - @ @ @ @ - - - - @ @ @ @ @ - - @ @ @ @ - - - - - - - -|
|- - - @ - - - - - - @ @ - - - - - - @ @ - - - - - @ - - - - @ @ - - - - - - - @ @ @ @ @ - - - - - - - - - - - - - @ - - @ @ @ - - - - @ - - - - - @ @ @ @ - - - - @ - @ @ @ - - @ - @ - - - - - - - - -|
|- - - @ @ @ @ @ - - @ @ - - - @ @ @ @ @ @ @ @ @ @ @ @ @ - @ @ @ @ @ @ @ - - - - - @ @ - - - - @ @ - - - - - - @ @ @ - - @ @ @ - - - - @ @ - @ @ @ @ - - - - - - - @ - @ @ - - - @ @ @ @ @ - @ @ @ - - -|
|- - - @ - - @ @ @ @ @ @ - - - - @ @ @ @ - - - @ @ @ @ @ @ @ @ @ @ - @ @ @ @ - - - @ @ - @ - @ @ @ @ - - - - - @ @ - - - - - @ @ - - @ @ @ - @ @ @ @ @ @ - - - - - @ - - - - - - @ @ @ @ @ - - - - - - -|
|@ @ @ @ @ - @ @ @ @ - @ @ @ @ - - - - - - @ @ @ - @ @ @ @ @ @ - - - @ - @ @ @ @ @ @ @ @ @ - - - - @ @ - - - - - - - - - - - - @ - - - - - - - - - - - - - - - - - - - - - - - - - @ @ @ @ @ @ - - - - -|
|@ @ @ - - - - @ @ - - @ - @ - - - - - - - @ @ - - @ @ - - - @ - - - @ @ @ - - - - @ - @ @ @ @ - @ @ @ - - - - - - - @ @ @ - @ @ - - - - - - - - - @ @ @ @ @ - - - - - - - - - @ @ @ @ @ @ - @ @ @ @ - -|
|- - @ - @ @ - - - - - - - @ - - - - @ - @ @ @ - @ @ @ @ @ - @ @ @ @ @ @ @ - - - - @ - @ @ @ @ @ @ @ @ @ @ - - - - - - - @ @ @ - - - - - - - - - - @ @ - - - - - - - - - @ @ - @ @ - @ - @ - @ @ @ - - -|
|- - @ - @ @ - - @ @ - - - @ - - - @ @ - - - - - - - @ @ @ - @ @ @ - - @ @ - - - @ @ @ @ @ @ - @ @ @ @ - - - - - - - - - - - - - - @ @ - - - - - @ @ @ - - - @ @ @ - - @ @ @ - - - - @ - - - @ - - - - @|
|@ @ @ - @ @ - - @ @ @ @ - @ @ @ - @ @ @ @ - @ @ - - - - - - - - @ - @ @ @ @ @ - @ @ @ - @ @ - @ - @ @ - @ @ @ - - - - - - @ @ - - @ @ @ @ - - - @ @ - - - - - - @ @ @ @ - - - - - - - - @ @ @ - - - - @|
|@ @ - - @ @ - - - @ @ @ - - @ @ - @ - @ @ - @ @ - - - - @ @ - - @ - @ @ @ @ @ @ @ - @ - @ @ - @ @ @ @ - - - - - @ @ - - @ @ @ @ @ @ - @ - - - - - - - - - - - - - - - - - - - - - - - - @ @ @ - @ @ - @|
|- - - - - - - - - @ - @ - - - - - - - @ - - - - - - - - @ @ - - @ - @ - - - - @ @ @ @ - @ @ @ @ - - - - - - - - @ @ - - - - - - - - - @ - - - - - - - - - - @ @ @ @ - @ @ - - - - - - - @ @ @ @ @ @ @ @|
|- - - - - - - - @ @ - @ - - - - - - - @ - - - - - - - - @ @ - - - - - - - - - @ @ @ - - - - - - - - - - - - - - - - - - - - - - - - @ @ @ - @ @ - - - - - - - - - @ - @ @ @ @ - - - - @ @ - @ @ - - @ @|
|@ - - @ @ @ @ @ @ @ - @ @ - - - - - - @ - - - - - @ @ - - @ - - - - - - - - - @ - @ @ - - - - - - - - - - - - @ @ @ - - @ @ @ - - - @ @ - - @ @ - @ @ @ - - - - - @ - - - - @ - - - - @ @ - - @ - - @ @|
|@ - - @ @ - - @ @ @ @ @ @ @ @ - - - - - - - - @ - @ @ - - @ - @ @ @ - - - - - - - @ @ @ @ @ - - - - @ @ - - - - - - - - - @ @ - - - @ @ @ @ @ - - @ @ @ - - - - @ @ @ @ - - @ - - - - @ @ - @ @ @ - - -|
|@ - - - - - - @ @ - @ @ - - @ @ @ @ - - - - - @ - - @ - - - - - - @ @ @ - - - - - - @ @ @ @ @ @ @ - @ @ - - - - - - - - @ @ @ @ - - @ - - - @ - - - - @ @ @ @ - @ - @ @ - @ @ @ - - - @ @ @ @ - - - - -|
|- - - - - - - - - - - - - - @ @ - @ @ @ - - - @ - - @ - - @ @ - - - @ @ @ - - - - - @ @ - - - - @ @ @ @ - - @ - - - - - @ - - @ - - - - - - @ @ @ - - @ - - - - @ - - - - @ @ @ @ @ - - @ @ @ - - @ @ @|
|- - - - - - - - - - - - - - - - - @ @ - - - - @ @ @ @ @ @ @ @ - - - @ @ @ @ @ @ @ - - - - - - - - - @ @ @ @ @ - - - - - @ - @ @ @ @ @ - - @ @ - @ - @ @ @ @ @ @ @ @ - - - - - @ @ @ @ - - - @ - - - - -|
|- - - - - - - - - - - - @ @ @ @ - @ @ @ @ - - @ - - - @ @ @ - - - - - @ @ @ @ @ @ - - - - - - - - - - - - @ @ @ - - - @ @ @ @ - - - @ - - @ @ - @ @ @ @ @ @ @ @ @ @ @ @ @ - - - @ - @ @ - - @ - - @ @ @|
|- - - - - - - - - - - @ @ @ @ @ @ @ @ @ @ - - - - - - - - @ @ @ - - - @ - - - - - - - - - - @ @ @ - - @ - @ @ @ @ @ @ @ - - @ - - - @ - - - @ @ @ @ @ - - @ @ @ @ @ @ @ - - - - @ - @ @ - @ @ - - - - -|
|- - - @ @ @ - - - - - @ @ - @ - - - @ @ @ @ @ @ - - - @ @ @ @ @ - - - @ @ @ @ - - - @ @ @ - @ @ @ @ @ @ - - @ @ @ @ @ @ - - @ - - - @ - - - - @ @ @ - - - @ @ @ @ @ @ @ - - - - @ @ @ - - @ - - - - - -|
|- - - @ @ @ @ - @ @ @ @ - - @ - - @ @ @ @ @ @ - - - @ @ - - @ @ @ - - @ @ @ @ - - - - - - - @ @ - - @ @ - - - - - - @ @ @ - @ - - - - - @ @ - - - @ @ @ - - @ @ @ @ - @ @ @ - - @ @ - - - @ @ @ - @ @ -|
|- - @ @ - - - - - - - - - - @ @ @ @ - @ @ @ @ @ - - @ - - - - @ - - - - - @ @ @ - - - - @ - - @ - - @ - - - @ @ - - - - - - @ - - - - - @ @ - @ @ @ @ @ @ - @ @ - @ - - - - - @ @ @ - - - - @ @ @ @ @ -|
|- - @ @ - - - - - - - - - - @ - - - - - - @ @ @ - - @ - - - - @ - - - - - - @ @ - - - - @ - - - - - @ @ @ @ @ @ @ @ - - - - @ - - @ @ @ @ @ - - - - @ @ @ - - @ @ @ @ @ @ - - @ @ @ @ @ @ @ @ @ @ - @ @|
|@ @ @ - - - - - - - - - - @ @ @ @ - - @ - - - @ - - @ @ - @ - @ @ @ @ - - - @ @ - - - @ @ - - - - - @ - - @ @ @ @ - - - - - - - - @ @ - @ @ - - - - @ - @ @ @ @ @ - - - - - - - - - @ @ @ @ - - - - @ @|
|@ @ - - - - - - - - - - - @ @ - - - - @ - @ - - - - @ @ - @ - - @ @ @ - @ @ @ @ - - - @ - - - - - - @ @ @ @ - - @ - - - @ @ @ - - - - - @ @ - - - - @ - - @ @ @ @ @ @ - - - - - - - - - - - - - - - - -|
|- - - @ @ @ - - - - - - - - - - - - - @ - @ - - @ @ @ @ @ @ @ - @ @ - - - - - @ @ @ - @ - - - - - - @ @ @ @ - - @ - @ @ @ @ @ @ @ - - - @ @ @ - - - - - - - - @ - @ @ @ @ @ - - - - - - - - - - - - - -|
|- - - - @ @ @ @ - - - - - - - - - - - - - @ - - - - - @ - - - - @ @ @ @ @ - - - - - - @ - - - - - - - - - - - - @ - - - @ - - @ @ @ - - - - @ @ @ - @ @ - - - @ - - - @ @ @ - - - - - - - - @ @ @ @ @ -|
