20 6
|- - - - - - - - @ - @ - - - @ - @ - - @|
|- - @ - - - - - @ - @ - - @ @ - @ @ @ @|
|- @ @ - - - - - @ - - - - @ @ @ @ @ @ @|
|- @ @ - - - @ @ @ @ - @ - - - @ @ @ - -|
|@ @ - - - - @ @ @ @ - @ - @ @ @ - @ @ -|
|@ - - - - - - @ @ @ - @ - - - - - @ @ @|
