50 50
|- - - - - - - - - - - - - - - @ - - - - - - - - - @ @ @ - - - - - - - - - - - - @ @ - - - - - - - -|
|- - - - - - - - - - - - - - - @ - - - - - - - - - - - @ @ - - - - - - - - - - - @ @ - - - - - - - -|
|- - - - - - - - - - - @ @ @ - @ - - - - - - - - - - - @ @ - - - - - - - - - - - @ @ @ @ @ - - - - -|
|- - - - - - - - - - - - - - - - - - - - - - - - - - - @ - - - - - - - - - - - @ @ - - @ @ @ @ @ - -|
|- - - - @ - - - - - - - - - - - - - - - - - - - - @ @ @ - - - - - - - - - - - @ - - - @ - @ - - - @|
|- - @ @ @ - - - - - - - @ - - - - - - - - - - - - @ @ - - - - - - - - - - - - @ - - - @ - @ - - - @|
|- - - - @ - - - @ - @ @ @ - - - - - - - - - - - - - - - - - - - - - - - - - @ @ @ @ - - - @ - - @ @|
|- - - @ @ - - - @ - - - @ @ - - - - - - - - - - - - - - - - - - - - - - - - @ @ @ @ @ - - @ @ - @ -|
|- - - @ @ - - - @ - - - - @ @ @ - - - - - - - - - - - - - @ @ - - - - - - - - - - @ @ - @ @ @ - @ @|
|- - - - - - - - - - - - @ @ @ - - - - - - - - - - - - @ @ @ @ - - - - - - - - - - - - - @ @ - - @ @|
|- - - - - - - - - - - - - - - - - @ - - - - - - - - - @ @ - - - - - - - - - @ @ - - - - @ - - - - @|
|- - - @ - - - - - - - - - - - - - @ - - - - - - - - - - - - - - - - - - - - @ @ - - - - @ @ @ @ - -|
|- - - @ - - - - @ - - - - - - - - @ - - - - - - - - - - - - - @ @ @ - - - - - - - - - - - - - - - -|
|@ @ - @ - - - - @ - - @ - - - - - - - - - - - - - - - - - - - - - - - - @ - - - - - - - - - - - - -|
|- - - - - - @ - @ - - @ - - @ @ - - - - - - @ @ - - - - - - - - - - - - @ - - - - - @ - - - - - - -|
|- - - - - - @ - - - - @ - - @ @ - - - - - - @ @ - - - - - - - @ - - - - @ - - - - - @ - - - - - - -|
|@ @ - - - - @ - - - - - - - - @ @ @ - - - - @ @ - - - - - - - @ - - - - - - - - - - @ - - - - - - -|
|- - - - - - - - - - - - - - - - @ @ - - - - - - - - - - - - - @ - - - - - - @ @ @ - - - - - - - - -|
|- - @ @ @ - - - @ - - - - @ @ @ @ - - - - - - - - - - - - - - @ @ - @ @ @ - - - - - - - - @ - @ - -|
|- - - - - - - - @ - - - - - - - - - - - - - - - - - - - - - - - @ - - - - - - - @ @ @ - - @ - @ - @|
|- - - - - - - @ @ - - - - - - - - - - - - - - - - - - - - - - - @ @ @ - - - - - @ - - - - @ - @ - @|
|- - - - - - - @ - - - - - - - - - - - - - @ - - - - - - - - - - - @ @ @ - - - - @ - - @ @ @ - - - @|
|- - - - - - - @ - - - - - - - - - - - - - @ - - - - - - @ @ @ - - - - @ @ - - - @ - - @ @ - - - - -|
|- - - - - - - @ - - - - - - - - - - - - - @ - - - - - - - - - - - - - @ @ - @ @ @ - - - - - - - - -|
|- - - - - - - - - @ @ - - - - - - - - - - - - - - - - - - - - - - - - - - - @ @ @ @ @ - - - - - - -|
|- - - - - - @ - - @ @ - - - - @ - - - - - - @ - - - - - - - - - - - - - - - - - - - - - - - @ @ @ -|
|- - - - - - @ - - - - - - - - @ - - - - - - @ - - - - - - - - - - - - - - - - - - - @ - - @ @ - - -|
|- - - - - @ @ @ @ - - - - - - @ - - - - - - @ - - - - - - - - - - - - - - - - - - - @ - - @ - - - -|
|- - - - - @ @ - @ @ @ @ - - - - - @ - - - - - - - - - - - - - - - - - - - - - - - - @ - @ @ @ - - -|
|- - - - - - - - @ @ @ @ - - - - - @ @ - - - - - - - - - - - @ @ @ @ @ @ - - - - - - - - - @ @ @ - -|
|- - - - - - - - - - - - - - @ @ @ @ @ - - - - - - - @ @ - - - - @ @ @ - - - - - - - - - - @ - - - -|
|- - - - - - - - - - - - - - - - - - @ - - - - - - - @ @ @ @ @ @ @ @ - - - - - - - - - - - @ @ - - -|
|@ @ @ - - - - - - - - - - - - - - - @ - - - - - - - - - @ @ @ @ @ @ - - - - - - - - - - - - @ - - -|
|@ - - - - - - - @ - - - - - - - - - - - @ @ @ @ - - - - - - @ @ - - - - - - - - - - - @ @ @ @ - - -|
|@ - - - - - - - @ - - - - - - - - - - - @ - - - - - - - - - @ @ - - - - - - - - @ @ @ @ @ @ - - - -|
|- - - - - - - - @ - - - - @ @ - @ - - - @ - - - - - - - - @ @ @ - - - - - - - - @ - - - - @ - - - -|
|- - - - - - - - - - - - - @ @ - @ @ @ - - - - - - - - - - - - @ - - - - - - - - @ - @ @ - @ @ - - -|
|- - - @ @ @ - - @ - - - - - - - @ - - - - - @ @ - - - - - - - - - @ @ @ - - - - @ - @ @ - - @ @ - -|
|- - - - - - - - @ - - - - - - - @ @ @ - - - @ @ - - - - - - - - - - - - - - - - @ @ @ - - - @ @ - -|
|- - - - - - - - @ @ @ - - - - - - - - - - - @ - - - - - - - - - - - - - - - - - - @ - - - - - - - -|
|- - - - - - - - - @ @ @ @ @ @ @ @ - - - - - - - - - - - - - - - - - - - - - - - - @ - - - @ @ - - -|
|- - - - - - - - - @ @ - - - - @ @ - - - - - - - - - - - - - - - - - - @ @ @ - - - @ - - @ @ @ - - -|
|- - - - - - @ - - @ @ - - - - - - - - - - - - - - - - - - @ @ - - - - - - - - - @ @ @ @ @ - - - - -|
|- @ - - - - @ - - - - - - - - - - @ @ @ - - - - - - @ - - @ @ - - - - - - - - - @ @ @ @ - - - - - -|
|- @ - - - @ @ - - - - - - - - - - - - - - - - @ @ @ @ - - - - - - - - - - - - - @ - @ @ - @ @ - - -|
|- @ - @ @ @ - - @ @ - - - - - @ - - - - - - - - - - @ - - - - - - - - - - - - - @ - - - - @ @ - - -|
|@ @ - @ @ @ - - @ @ - - - - - @ - - - - - - - - - - - - - @ @ - - - - - - - - - - - @ @ @ @ @ - - -|
|- - - - - @ - - - - - - - - - @ - - @ - - @ - - - - - - - @ @ - - - - - - - - - - - - @ @ @ - - - -|
|- - - - - - - - - - - - - - - - - - @ - - @ - - - - - - - - - - - - - - - - - @ @ - - - - - - - - -|
|- - - - - - - - - - - - - - - - - - @ - - @ - - - - - - - - - - - @ @ @ - - - @ @ - - - - - - - - -|
