10 10
|@ @ @ @ @ @ - - - -|
|- - @ @ @ - - - - -|
|- - - - - - @ - - -|
|- - @ @ - - @ - - -|
|@ @ @ @ - - @ - - -|
|- - - @ @ - @ @ @ -|
|- - @ @ @ @ @ - - -|
|- - @ - - @ @ - - -|
|- - @ - - @ @ @ @ @|
|- - - - - - - @ @ -|
