50 50
|@ @ - @ - - - - - - - - @ @ @ @ - - @ @ - @ @ - @ - @ @ - - - - - - - @ - - - - - - @ @ @ @ @ - - -|
|- - - @ - - - - - - - - @ - - - - - @ @ @ @ @ - @ - @ @ @ @ - - - - - @ @ @ - - - - @ @ - @ @ @ - @|
|@ - - - - - - @ @ - - @ @ - - - - - @ @ - - @ - - - - - @ @ - @ @ @ @ @ @ @ - - - - @ @ - - - @ @ @|
|@ @ - - - - - @ @ - - @ - - - - - - @ @ @ @ @ - @ @ @ @ @ @ - @ @ @ @ @ @ @ - - - - - - - - - @ @ @|
|@ @ @ @ @ - - - - - - @ - - - @ - - - - - @ @ - - @ - @ - - - @ @ @ @ - @ @ @ @ - - - - - @ - @ - @|
|- @ - - - - - - - - - - - - - @ - - - - - @ - - - @ - @ - - - @ - @ @ - @ @ @ @ - - - - - @ - - - -|
|- @ - - @ @ @ @ - - - - - - - @ - - - - @ @ - - - @ - @ - - - @ - - - - - - - - - - - - - @ - - - -|
|- @ - - - - @ @ @ @ @ - @ @ - - - - @ @ @ @ - - @ @ - - - - - @ - - - @ @ @ - - - - - - @ @ @ - - -|
|- - - - - - - @ @ @ - - @ @ - - - - - - - @ - @ @ @ @ @ - - - - - - - @ - - - - - - @ @ @ @ - - - -|
|- - - @ @ - - - - - - - - - - - - @ @ - - @ - @ @ @ @ @ - - - - @ @ @ @ - - - - - - @ - - - - - - -|
|@ @ - @ @ @ - - - - - - - - - @ @ @ @ - - @ @ @ - @ - @ @ @ @ @ @ @ @ @ @ @ @ - - - @ @ @ @ - - - -|
|@ @ - - - @ - - @ @ - - - - - - - - - - - @ @ - - @ - - - - - - - @ @ @ @ @ @ @ @ @ @ @ - @ @ - - -|
|- - - @ @ @ - - @ @ - - - - - - - - - - - @ @ - - @ - - - - - - - @ @ @ - - - - - - - - - - @ - - @|
|@ @ - @ @ @ @ - @ @ @ @ - - - - - - - @ @ @ - - - - - - - - - - - - @ @ - @ @ @ @ @ - - - - @ - - @|
|@ @ - - - @ @ - @ @ @ @ @ @ - - - - - - - - - - - - - - @ @ @ @ - - - @ @ @ - - - @ - - - - - - - @|
|- - - - - - @ - @ @ @ @ @ @ - - - - - - - @ @ - @ - - - @ @ @ @ - - - - @ @ @ - @ @ - - - - - - - @|
|- - - @ @ - @ @ @ - @ @ @ @ @ - - - - - - @ @ - @ @ @ @ @ @ - @ - - - @ @ - @ @ @ - - - - - - - - @|
|- @ @ @ @ - - @ @ @ @ @ - - - - - - - - - - - - @ @ - - - @ - @ @ @ @ @ - - @ @ @ - - @ - - - - - -|
|- @ - @ @ - - - - - @ @ - - @ @ - - - - - - - - @ @ - @ - @ - @ - - @ @ @ @ @ - - - - @ - - - - - -|
|- @ - @ @ - - - - - @ @ @ - @ @ - - - - - - - - - - - @ - @ - - - - - - - @ @ - - - - @ - - - - - -|
|- @ - - - - - - - @ @ @ - - @ @ @ @ - - - - - - - - - @ - - - @ - @ - @ @ @ @ @ @ @ @ @ - - @ @ - -|
|@ @ - - - @ @ @ @ @ - @ - - - - - @ - - - @ @ - - - @ @ @ @ - @ - @ - - - - @ @ - - @ @ @ @ @ @ - @|
|@ - - - - @ @ @ @ - - @ @ - - @ @ @ @ - - @ @ @ @ @ @ - @ @ @ @ @ @ @ @ @ - - - - - - - @ @ - - - @|
|@ @ - - - - - - - - - @ @ - - @ @ @ @ @ - - - @ @ @ @ @ @ - - - - - - @ @ - @ @ @ - @ @ @ @ - - - @|
|- @ @ @ @ - - - - - @ @ @ - - - - @ @ @ @ - - @ @ - - @ - - - - - - @ @ @ @ @ - @ @ @ - - - - - - @|
|@ @ @ - - - - - - - @ - - - - - - - - - @ @ @ @ @ @ @ @ - - - - - - @ @ @ @ - - @ @ @ - - - - - - @|
|@ - - - - - - - - - @ @ - - @ - @ @ @ - - @ - - @ - - @ @ @ @ - - - @ - - @ @ @ @ - - - @ @ @ - - -|
|@ - - - - - - - - - @ @ - - @ - - @ @ @ - @ @ - - - - - - @ @ @ - - - - @ @ - - @ @ @ - - @ @ - - -|
|@ - - - - - - - - @ @ @ @ @ @ - - @ - @ - @ @ - - - - - - - - - - - - - @ - - - - @ @ - - @ @ @ @ -|
|- - - - @ - - - - - - - - @ @ - - @ - @ - @ @ - - - - - - @ - - - - - @ @ @ - - - @ @ - - - - - - -|
|- - - - @ - - - - - - - - - @ @ @ @ - @ - @ @ - @ - - - - @ - @ - - - @ @ @ - - - - - - - - - - - -|
|@ - - - @ - - - - @ @ - - - @ @ @ @ - - - - @ - @ - - - - @ - @ - - @ @ - - - - @ @ @ @ - - - - - -|
|@ - - - - - - - - @ @ - - - @ - - - - - - - - - @ - - - - - - @ - - @ - - @ @ @ @ @ - @ @ - - - - -|
|@ - - - - - - - - - - - - - @ @ @ @ - - - - - - @ - - - - - - - - - @ - @ @ - - - @ @ @ @ - - @ @ -|
|- - - - - - - - - - - - @ @ @ - - - - - - - - - @ - @ @ @ - - - - - - - @ @ - - - @ @ @ @ - - @ @ @|
|- - - - - - - - @ @ @ - @ @ - - @ - - @ @ @ @ @ @ - - - @ @ - - - - - - - - - - - - @ @ - - - @ @ @|
|- - - - - @ @ - @ @ @ @ @ @ - - @ - - @ @ @ @ @ @ - - - @ @ - - - - - - - - - - - - - - - - - @ @ @|
|@ @ - - - @ @ - - - - @ @ @ - - @ - - - - - - - @ @ @ @ @ @ - - - - - @ @ @ - - @ @ @ @ @ @ - - @ @|
|@ @ @ @ @ @ @ @ - - - - - - - - - - - - - - - - - - - - @ @ - @ @ @ @ @ @ - - - - - - - - - - - @ -|
|- - - - - - @ @ - - - - @ @ @ - - @ @ @ - - - - @ - - @ @ - - @ @ @ @ @ @ @ @ @ @ - @ @ @ - - - @ -|
|- - - @ @ @ @ @ @ - - - - - @ @ @ @ @ @ @ @ - - @ @ @ @ - - - - @ @ @ - @ @ - - - - - - - - - - - -|
|- - - - - - - - @ - - - - - - - - @ - @ @ @ - - @ - - @ - - - @ @ - - - - @ - - @ @ @ @ @ - - - @ @|
|- @ @ @ - - - - @ @ @ @ @ - - - - - - - - - - - - - - - - - @ @ @ @ - - - @ @ @ @ @ - - - - - - @ @|
|- - - - - - - - - - - @ @ - - - - - - - @ @ @ - - - - - @ @ @ - - - - - - - @ @ @ - - - - - - - - -|
|- - - - - - - - - - - - - - - @ - @ @ @ @ - @ @ - - - - - - @ @ @ - @ @ - - - @ @ - - - - - - @ @ @|
|@ @ @ @ - @ @ @ @ - - - - - - @ - - - - - - @ @ @ @ @ - - - - - @ @ @ @ - - @ @ @ - - - - - - @ @ -|
|@ @ @ @ @ @ @ - @ - @ - - @ @ @ - - - - - @ @ @ @ - - - - - - - - - - - - - @ - - - - - - - - - - -|
|@ - - - - - - - @ - @ @ @ @ @ - - - - - - @ @ - - - - @ @ - - - - - - - - - @ @ @ - - @ @ - - - - -|
|@ - - - - @ @ @ @ - @ - - - - - - - - - - - @ @ - - - @ @ - - - - - - - @ - @ @ @ - - @ @ @ - - - -|
|@ @ @ - - @ @ @ @ @ @ @ - - - - - - @ @ @ - - @ - - - @ @ @ - - - - - - @ - @ - @ @ - @ @ @ - - - -|
