20 6
|- - - - - - - - - - - - - - - - - - @ @|
|- - - @ @ @ - @ - - - - - - - - - - - -|
|- - - - - - - @ - - - - - - - - - - - -|
|- - - - - - - @ - - - @ - - - - - - - -|
|- - - - - - - - - @ - @ - @ @ - - - - -|
|- - - - - - - - - @ - @ - @ @ - - - - -|
