50 50
|- - - - - @ @ @ - @ - - @ - @ - - @ @ @ - - - @ @ @ - - - - @ - - - - - @ @ @ @ @ - - - - - - @ - -|
|- - @ @ @ @ @ @ - @ - - @ - @ - - - - - - - @ @ @ - - - - @ @ - - - @ @ @ - - @ @ @ @ @ @ @ - @ - -|
|- - @ @ @ - - - - @ @ - - - - - - - @ @ @ @ @ - @ - - - - @ - - - @ @ @ @ - - @ - @ @ - @ @ @ @ @ -|
|- - - @ @ @ @ @ @ @ @ - - - - - - @ @ @ - - @ - @ - - - - @ - - - @ @ - - - - @ @ @ @ - - - - @ @ -|
|- - - - - @ @ @ @ @ @ - - - - - - @ @ - - - - - - - - - - - - - - - - - - - - - - - - - - - - - - -|
|- @ @ - - @ - - @ @ - - - - - - - - @ - - - - @ @ @ - - - - - - - - - - - @ - @ @ @ - - - - @ - - -|
|- @ @ - - - - - @ @ - - - @ @ - - - @ - - @ @ @ @ @ - - - - @ - @ - - @ @ @ @ @ - - - - - @ @ - - @|
|- @ @ - - - - - - - - - - @ @ - - - @ @ @ @ @ - @ @ - - - - @ - @ - @ @ @ @ @ @ @ - - - - @ @ - - @|
|- @ - - @ - - - - @ @ - - - - - - - - @ @ - - - - - - @ @ - @ - @ @ @ - - - @ - @ - - - - @ @ - - @|
|- @ @ @ @ - - @ @ @ @ - @ - - - - - - @ - - - - - - - @ @ @ @ - - @ @ - - - @ - @ @ @ - - - - - - -|
|- - - - @ @ - @ @ - - - @ - - - - @ @ @ - - - - - - - - @ - - - - @ - - - - - - @ - - - - - - - - -|
|- @ @ @ @ @ - @ - - - - @ - - - - - - @ - - - - - @ @ @ @ - - - - @ @ @ @ - - @ @ - - - - - - - - -|
|- - - - - @ - @ - - - - - - - - @ @ @ @ - - - - - - @ @ - - - - - @ - @ @ - @ @ @ - - - - - @ - - -|
|- @ @ @ - @ - @ @ @ @ - - - - - @ @ - - - - @ @ - - @ @ @ - @ - @ @ @ @ @ - @ - - - - - - - @ - - @|
|- @ @ @ - @ @ @ @ @ @ - - - - - - - - - - - @ @ - - - - @ - @ - @ - - - @ @ @ @ - - - - - @ @ @ - @|
|- - - - - - @ - @ @ @ - - - - - - - - - @ @ @ @ - - @ @ @ - @ - @ - - - @ @ - @ - - - @ @ @ - - - -|
|- - @ @ - - @ - - - - - - - - - - - - - @ @ - - - - @ @ @ - - - - - @ @ @ @ - @ - - - @ @ - - - @ -|
|- @ @ @ @ - @ @ - - - @ @ @ - - - - - - - - - - - - - - @ - - - - @ @ - - @ - @ @ @ @ @ - - - - @ @|
|- @ @ @ @ - @ @ - - - - - @ - - @ - - - - - - - - - - - @ - - @ @ @ @ @ - - - - - - - @ - - - - @ @|
|- @ @ @ @ @ @ - - - - - - @ - - @ - - - - - - - - @ @ @ @ - - - - @ - @ @ @ - - - - - @ @ @ @ - - @|
|- @ @ @ - - @ @ @ @ @ @ @ @ @ @ @ - - - - - - @ @ @ @ - - - - - @ @ @ @ @ @ @ @ @ - - - @ @ - - - @|
|- - @ @ @ @ @ - - @ @ @ @ - @ @ @ @ - - @ - - - - - @ - @ @ @ @ @ @ @ - - - @ @ - - - - @ @ - @ @ @|
|@ @ @ - - - - - - - - @ @ - @ - @ @ - - @ - - - @ - @ - @ @ @ - @ @ - - - - @ @ - @ @ - - @ @ @ @ -|
|- - - - - @ @ - - - - - @ @ @ @ @ @ @ - @ - - - @ - - - - - @ @ @ @ @ - - @ @ - - @ @ @ @ @ @ @ @ -|
|- @ @ - - @ @ - - - - - @ @ - @ @ @ @ - - - - - @ @ - - - - - - @ - @ - - @ @ @ @ @ - - - - @ @ - -|
|- @ @ - - - - - - - - - @ @ - @ - @ @ - - - - - @ @ - - - - @ @ @ - @ - - @ @ @ - - - @ @ @ @ @ @ @|
|- - - - - - - - - - @ @ @ - - @ - @ @ @ - - - - - - - - - - @ @ @ - - - - @ - - - - - - @ @ @ @ @ @|
|@ @ - - - - - - @ @ @ @ @ - - - - - @ @ - - @ - - - - - - - - @ @ - - - - @ - - - - - - @ @ - @ - -|
|- - - - - - - - - - - - - - - @ @ @ @ - - - @ - - - - - - - - @ @ @ @ @ - @ - - - - - - @ - - @ - -|
|- - - - - - - - - - - @ @ @ @ @ @ @ @ - @ @ @ - @ @ - - - - - @ @ - - - - @ @ - - - - - - - @ @ - @|
|- @ @ @ - - - - - - - - - @ @ @ @ - - - @ @ @ - @ @ - - - - - - - - - - @ @ @ @ - - - - - - @ @ - @|
|@ @ @ @ @ @ @ - - - - - - @ - - @ - @ @ @ - - - - @ @ @ @ - - - - - - @ @ @ - @ - - - - - - @ - - @|
|- @ @ - @ @ @ @ @ - - - - @ - - @ - @ @ @ - - - - - - - @ - - - - @ - - - - - @ - - - - - - @ - - @|
|@ @ @ - - - @ - - - @ @ @ @ - - @ - - - - - - - - - - - @ - - - - @ - - - @ @ @ - - - - - - - - - -|
|@ @ @ - - - - - - - @ - @ @ - - - - - - - - - - - - - - - - - - - @ - - - @ @ - - - @ @ @ - - - - -|
|- - - - - - - - - - @ - @ @ - - - @ - - - - - - - - - - - - - - - - - - - - - - - @ @ @ - - - - - -|
|- - - - - - - - - - @ - - - - - - @ - - @ @ @ @ - - - - - - - - @ @ @ - - - @ - - - - @ @ @ @ @ - -|
|- - - - - @ @ @ - - - - - - - - - @ @ - @ @ @ - - - - - - - - - @ @ - - - - @ - - - - @ @ @ @ @ - -|
|- - - - - - @ - - - - - - @ - - - @ @ - - - @ @ - @ - - - - - - @ @ - - - - @ - - - - - @ - - @ @ @|
|- - - - - - @ @ - - - - - @ @ - @ @ @ - - @ @ @ @ @ - - - - - - - @ @ @ @ - - - - - - - @ @ @ @ @ @|
|- - @ @ @ - @ @ - - - - - @ @ - @ @ - - - - - - @ @ - - - @ @ @ - - - @ @ - - - - - - - - @ @ - - -|
|- - @ @ - - - @ - - - - @ @ @ - @ @ @ @ @ @ - - @ - - - - - - @ - - - @ @ - @ @ @ - - - - - - - - -|
|- - @ @ - @ @ @ - - - @ @ - - - - - - @ @ @ - - - - - - - - - @ - - - - - - - - - - - - - - - - - -|
|- - @ - - - @ @ - - - @ @ - - - - - - @ - - - @ @ @ - - - @ @ @ - - - - @ @ - - - - - - - - - - - -|
|- - @ - - - @ @ - - @ @ - - - - - - - - - - - @ @ @ - @ @ @ @ - - @ @ - @ @ - - - - - - - @ - - - -|
|- - - - - - - - - - @ @ - - - - @ - - - - - - @ @ @ @ @ @ @ @ - - @ @ - - - - - - - @ @ @ @ - @ @ @|
|@ @ - - - - - - - - - - - - - - @ - - @ @ @ - @ @ @ @ - - @ @ - - - - - - - @ @ @ - - - - @ - @ @ @|
|- - - - - - - - - - @ @ @ @ - - @ - - - @ @ @ @ @ @ @ - @ @ - - - @ @ @ @ @ @ @ @ - - - - - - - - @|
|- - - - - - - - - - - - @ @ - - - - - - - - - - - - @ - @ - - - - - - @ @ @ - @ @ - - - - - - - - @|
|- - - - - - - - @ @ - - - @ - - - - - @ @ @ - - @ @ @ - @ - @ @ - - - @ - - - - - - - - - - - - - -|
