30 30
|- - - - - - @ - - - - - - - - @ - - - - - - - - - - - - - -|
|- - - - - - @ - - - - - - - - @ - - - - - - - @ @ - - - - -|
|- - - - - - - - - - - @ @ @ @ @ - - - - - - - @ @ - - - - -|
|- - - - - - - - - - - - - - - @ @ @ - - - - - @ - - - - - -|
|- - @ @ - - - - - - - @ @ @ - - - - - - - - - - - - - - @ -|
|- - @ @ - - - - - - - @ @ @ - - - - - - @ - - - - - - - @ -|
|- - - - - - - - - - - - - @ - - @ - - - @ - - - - - - - @ -|
|- @ @ @ - - - - - - - - - - - - @ - - - @ - @ @ - - - - - -|
|- - - - - - - - - - - - - - - - @ - @ @ @ - @ @ - - - - @ @|
|- - - - - - - - - - - - - - - - @ @ @ - - - - - - - - - @ @|
|- - - - - - - - - - - - - - - - @ @ - - - - - - - - - - - -|
|- - - - - - - - - - - - @ @ - - @ @ @ @ - - - - - - - - - -|
|@ @ @ @ - @ - - - @ @ - @ @ - - - @ @ @ - - - - @ @ @ - - -|
|@ - - - - @ - - - @ @ - - - - - - - - - - - - - - - - - - -|
|@ - - - - @ - - - - - - - - - - @ @ - - - - - - - - - - - -|
|- - @ @ - - - - - - - - - - - - @ @ - - - - - - - - - - - -|
|- - @ @ @ - - @ @ @ @ @ @ - - - - - - - - - - - - - - - - -|
|- - - - @ @ @ @ - - - @ @ @ - - - @ - - - - - - - - - - - -|
|- - - - - - - - - - - @ - - - - - @ - - - - - @ - @ @ @ - -|
|- - - - - @ @ - - - - @ @ @ - - - @ - - - - - @ - - - - - -|
|- - - - - @ @ - - - - @ @ @ - - - - - - - - - @ - - - - - -|
|- - - - - @ @ - - - - - - - - - - - - - - @ @ @ - - - - - -|
|- @ @ - - @ @ - - - @ @ @ @ - - - - - - - - - - - - - - - -|
|- @ @ - - - - - - - @ @ @ - - - - - - - - - - - - - - - - -|
|- - - - - - @ @ @ - - - @ @ - - - - - - - - - - @ @ @ - - -|
|- - - - - - - - - - - - @ @ - - - - - - - - - - @ @ - - - -|
|- - - - - - @ @ - - - - @ @ @ @ - - - - @ @ - - - - - - @ @|
|- - - - - - @ @ - - @ @ @ - - - - - - - @ @ - - - - - - - -|
|- - - - - @ @ @ - - - - - - - @ @ - - @ @ @ - - - - @ - - -|
|- - - - - @ @ - - - - - - - - @ @ - - - - - - @ @ - @ - - -|
