100 50
|- - - - - - - - - - - @ - - - - - - - - - - @ @ - - - - - - - - - - - - @ @ @ @ - - - - - - - - - - - - - - - - - - - - - - - - - - - - - - - - - - - - - @ @ - - - - - - - - - - - - - - - - - - - - -|
|- - - - - - - - - - - @ - - - - - @ - - - - @ @ - - - - - - - - - - - - @ @ @ @ - - - - - - - - - - - - - - - - - - - - - - - - - - - - - - - - @ @ - - - @ @ - - - - - - - - - - - - - - - - - - - - -|
|- - - - - - - - - - - @ - - - - - @ - - - - - - - - - - - - - - - - - - - - - - - - - - - - - - - - - - - - - - - @ - - - - - - - - - - - - - - @ @ - - - - - - - - - - - - - - - - - - - - - - - - @ @|
|- - - - - - - - - - - - - - - - - @ - - - - - - - - - - - - - - - - - - - - - - - - - - - - - - - - @ - - - - - - @ - - - - - - - - - - - - - - - - - - - - - - - - - - - - - - @ @ - @ - - - - - - - -|
|- - - - - - - - - - - - - - - - - - - - - - - - - - - - - - - - - - - - - - - - - - @ - - - - - - - @ - - - - - - @ - - - - - - - - - - - - - - - - - - - - - - - - - - - - - - @ @ - @ - - - - - - - -|
|- - - - - - - - - - - - - - - - - - - - - - - - - - - - - - - - - - - - - - - - - - @ - - - - - - - @ - - - - - - - - - - @ @ @ - - - - - - - - - - - - - - - - - - - - - - - - - - - @ - - - - - - - -|
|- - - - - - - - - - - - - - - - - - - - - - - - - - - - - - - - - - - @ @ - - - - - @ - - - - - - - - - @ - - - - - - - - - - - - - - - - - - - - - - - - - - @ - - - - - - - - - - - - - @ @ @ - - - -|
|- - - - - - - @ @ - - - - - - - - - - - - - - - - - - - - - - - - - - @ @ - - - - - - - - - @ @ @ - - - @ - - - - - - - - - - - - - - - - - - - - - - - - - - @ - - - - - - - - - - - - - - - - - - - -|
|- - - - - - @ @ @ - - - - - - - - - - - - - - - - - - - - - - - - - - - - - - - - - - - - - - - - - - - @ - - - - - - - - - - - - - - - - - - - - - - - - - - @ - - - - - - - - - - - - @ - - - - - - -|
|- - - - - - @ - - - - - - - - - @ @ @ - - - - - - - - - - - - - - - - - - - - @ @ - - - - - - - - - - - - - - - - - - - - - - - - - - - - @ @ @ - - - - - - - - - - - - - - - - - @ - - @ - - - - - - -|
|- - - - - - @ - - @ - - - - - - - - - - - - - - - - - - - - - - - - - - - - - @ @ - - - - - - - - - - - - - - - - - - - - - - - - - - - - @ @ @ - - - - - - - - - - - - - - - - - @ - - @ - - - - - - -|
|- - - - - @ @ - - @ - - - - - @ @ - - - - - - - - - - - - - - - - - - - - - - - - - - - - - - - - - - - - - - - - - - - - - - - - - - - - @ - - - - - - - - - - - - - - - - - - - @ - - - - - - - - - -|
|- - - - - @ @ - - @ - - - - - @ @ - - - - - - - - - - - - - - - - - - - - - - - - - - - - - - - - - - - - - - - - - - - - - - - - - - - - - - - - - - - - - - - - - - - - - - - - - - - - - - - - - - -|
|- - - - - - - - - - - - - - - - - - - - - - - - - - - - - - - - - - - - - - - - - - - - - - - - - - - - - - - - - - - - - - - - - - - - - - - - - - - - - @ @ - - - - - - - @ @ - - - @ @ - - - - - - -|
|- - - - - - - - - - - - - - - - - - - - - - - - - - - - - - - - - - - - - - - - - - - - - - - - - - - - - - - - - - - - - - - - - - - - - - - - - - - - - @ @ - - - - - - - @ @ - - - @ @ - - - - - - -|
|- - - - - - - - - - - - - - - @ - - - - - - - - - - - - - - - - - - - - - - - - - - - - - - - - - - - - - - - - - - - - - - - - - - - - - - - - - - - - - - - - - - - - - - @ @ @ - - - - - - - - - - -|
|- - - - - - - - - @ @ - - - - @ - - - - - - - - @ - - - - - - - - - - - - - - - - - - - - - - - - - - - - - - - - - - - - - - - - - - - - - - - - - - - - - - - - - - - - - - - - - - - - - - - - - - -|
|- - - - - - - - - @ @ - - - - @ @ - - - - - - - @ - - - - - - - - - - - - - - - - - - - - - - - - - - - - - @ @ @ - - - - - - - - - - - - - - - - - - - - - - - - - - - - - - - - - - - - - - - - - - -|
|- - - - - - - - - - - - - - - - @ - - - - - - - @ - - - - - - - - - - - - - - - - - - - - - - - - - - - - - - - - - - - - - - - - - - - - - - - - - - - - - - - - - - - - - - - - - - - - - - - - - - -|
|- - - - - - - - - - - - - - - - @ - - - - - - - - - - - - - - - - - - - - - - - - - - - - - - - - - - - - - - - - - - - - - - - - - - - - - - - - - - - - - - - - - - - - - - - - - - - - - - - - - - -|
|- - - - - - - - - - - - - - - - - - - - - - - - - - - - - - - - @ @ @ - - - - - - - - - - - - - - - - - - - - - - - - - - - - - @ @ - - - - - - - - - - - - - - - - - - - - - - - - - - - @ @ @ - - - -|
|- - - - - - - - - - - - - @ - - - - - - - - - - - - - - - - - - - - - - - - - - - - - - - - - - - - - - - - - - - - - - - - - - @ @ - - - - - - - - - - - - - - - - - - - - - - - - - - - - - - - - - -|
|- - - - - - - - - - - - - @ - - - - - - - - - - - - - - - - - - - - - - - - - - - - - - - - - - - - - - - - - - - - - - - - - - - - - - - - - - - - - - - - - - - - - - - - - - - - - - - - @ - - - - -|
|- - - - @ @ @ - - - - - - @ - - - - - - - - - - - - - - - - - - - - - - - - - - - - - - - - - @ @ @ - - - - - - - - - - - - - - - - - - - - - - - - - - - - - - - - - - - - - - @ @ - - - - @ - - - - -|
|- - - - - - - - - - - - - - - - - - - - - - - - - - - - - - - - - @ @ - - - - - - - - - - - - - - - - - - - - - - - - - - - - - - - - - - - - - - - @ - - - - - - - - - - - - - @ @ - - - - @ - - - - -|
|- - - @ @ @ - - - - - - - - - - - - - - - - - - - - - - - - - - - @ @ - - - - - - - - - - - - - - - - - - - - @ - - @ @ - - - - - - - - - - - - - @ @ - - - - - - - - - - - - - - - - - - - - - - - - -|
|- - - - - - - - - - - - - - - @ - - - - - - - - - - - - - - - - - - @ @ @ @ - - - - - - - - - - - - - - - - - @ - - @ @ - - - - - - - - - - @ @ @ @ @ - - - - - - - - - - - - - - - - - - - - - - - - -|
|- - - - - - - - - - - - - - - @ - - - - - - - - - - - - - - - - - - - - @ @ - - - - - - - - - - - - - @ @ @ - @ - - @ @ @ - - - - - - - - - - - - @ - - - - - - - - - @ - - - - - - - - - - - - - - - -|
|- - - - - - - - - - - - - - - @ - - - - - - - - - - - - - - - - - - - - - - - - - - - - - - - - - - - - - - - - - - - - @ - - - - - - - - - - - - - - - - - - - - - - @ - - - - - - - - - - - - - - - -|
|- - - - - - - - - - - - - - - - - - - - - - - - - - - - - - - - - - - - - - - - - - - - - - - - - - - - - - - - - - - - @ - - - - - - - - - - - - - - - - - - - - - - @ - - - - @ - - - - - - - - @ - -|
|- @ @ @ - - - - - - - - - - - - - - - - - - - - - - - - - - - - - - - - - - - - - - - @ - - - - - - - - - - - - - - - - - - - - - - - - - - - - - - - - - - - - - - - - - - - - @ - - - - - - - - @ - -|
|- @ @ @ - - - @ - - - - - - - - - - - - - - - - - - - - - - - - - - - - - - - - - - - @ - - - - - @ @ - - - - - - - - - - - - - - - - - - - - - - - - - - - - - - - - - - - - - @ - - @ @ - - - - @ @ @|
|- @ @ - - - - @ - - - - - - - - - - - - - - - - - - - - - - - - - - - - - @ @ @ - - - @ - - - - - @ @ - - - - - - - - - - - - - - - - - - - - - - - - - - - - - - - - - - - - - - - - @ @ - - - - - @ @|
|- @ @ - - - - @ - - - - - - - - - - - - - - - - - - - - - - - - - - - - - - - - - - - - - - - - - - - - - - - - - - - - - - - - - - - - - - - - - - - - - - - - - - - - - - - - - - - - - - - - - - - -|
|- - - - - - @ @ - - - - - - - - - - - - - - - - - - - - - - - - - - - - - @ - - - - - - - - - - - - - - - @ @ @ - - - - - - - - - - - - - - - @ - - - - - - - - - - - - - - - - - - - - - - - - - - - -|
|- - - - - - @ @ - - - - - - - - - - - - - - - - - - - - - - @ @ @ - - - - @ - - - - - - - - - - - - - - - - - - - - - - - - - - - - - - - - - @ - - - @ @ @ - - - - - - - - - - - - - - - - - - - - - -|
|- - - - - - - - - - - - - @ @ @ - - - - - - - - - - - - - - - - - - - - - @ - - - - - - - - - - - - - - - - - - - - - - - - - - - - - - - - @ @ @ - - - - - - - - - - - - - - - - - - - - - - - - - - -|
|- - - - - - - - @ - - - - - - - - - - - - - - - - @ @ @ - - - - - - - - - - - - - - - - - - - - - - - - - - - - - - - - - - - - - - - - - - @ @ @ - - - - - - - - - - - - - - - - - - - - - - - - - - -|
|@ @ - - - - - - @ - - - - - - - - - - - - - - - - - - - - - - - - - - - - - - - - - - - @ @ @ - - - - @ @ @ - - - - - - - - - - - - - - - - - - - - - - - - - - - - - - - - - - - - - - - - - - - - - -|
|- - - - - - - - @ - - @ @ @ - - - - - - - - - - - - - - - - - - - - - - - - @ @ @ - - - - - - - - - - - - - - - - - - - - - - - - - - - - - - - - - - - - - - - - - - - - - - - - - - - - - - - - - - -|
|- - - - - - - - - - - - - - - - - - - - - - - - - - - - - - - - - - - - - - - - - - - - - - - - - - - - - - - - - - - - - - - - - @ @ @ - - - - - - - - - - - - - - - - - - - - - - - - - - - - - - - -|
|- - - - - - - - @ @ @ - - - - - - - - - - - - - - - - - - @ - - - - - - - - - - - - - - - - - - - @ @ @ - - @ @ @ - - - - - - - - - - @ @ - - - - - - - - - - - - - - - - - - - - - - - - - - - - - - -|
|- - - - - - - - - - - - - - - - - - - - - - - - - - - - - @ - - - - - - - - - - - - - - - - - - - - - - - - - - - - - - - - - - - - - @ @ - - - - - - - - - - - - - - - - - - - - - - - - - - - - - - -|
|- - - - - - - - - - - - - - - - - - - - - - - - - - - - - @ - - - - - - @ @ - - - @ - - - - - - - - - - - - - - - - - - - - - - - - - - - - - - - - - - - - - - - - - - - - - - - - - - - - - - - - - -|
|- - - - - - - - - - @ @ - - - - - - - - - - - - - - - - - - - - - - - - @ @ @ @ @ @ - - - @ @ - - - - - - - - - - - - - - - - - - - - - - - - - - - - - - - - - - - - - - - - - - - - - - - - - - - - -|
|- - - - - - - - - - @ @ - - - - - - - - - - - - - - - - - - - - - - - - - - - - - @ - - - @ @ @ @ @ @ - - - - @ @ - - - - - - - - - - - - - - - - - - - - - - - - - - - - - - - - - - - - - - - - - - -|
|- - - - - @ @ @ - - - - - - - - - - - - - - - - - - - - - - - - - - - - - - - - - - - - - - - @ - - - - - - - @ @ - - - - - - - - - - - - - - - - - - - - - - - - - - - - - - - - - - - - - - - - - - -|
|- @ - - - - - - - - - - - - - - @ @ - - - - - - - - - - - - - - - - - - - - - - - - - - - - - @ - - - - - - - - - - - - - - - - - - - - - - - - - - - - - - - - - - - - - - - - - @ - - - - - - - - - -|
|- @ - - - - - - - - - - - - - - @ @ - - - - - - - - - - - - - - - - - - - - - - - - - - - - - @ - - - - - - - - - - - - - - - - - - - - - - - - - - - - - - - - - - - - - - - - - @ - - - - - - - - - -|
|- @ - - - - - - - - - - - - - - - - - - - - - - - - - - - - - - - - - - - - - - - - - - - - - - - - - - - - - - - - - - - - - - - - - - - - - - - - - - - - - - - - - - - - - - - @ - - - - - - @ @ @ -|
