10 10
|- - - - - - - - - -|
|- - - - - - - - - -|
|- - - - - @ @ - - -|
|- - - - - @ @ - - -|
|- - - - - - @ @ - -|
|- - - - - - - @ - -|
|- - - - - - - @ - -|
|- - - - - - - - - -|
|- - - - - - - - - -|
|- - - - - - - - - -|
