20 20
|- - - - - - - @ @ @ - - - - - - - - - -|
|- - - - - - - @ @ - - - - - - - - - - -|
|- - - - - - - @ @ - @ @ @ - - - - - - -|
|- - - - - - - - - - - - - - - - - - - -|
|- - - - - - - - - - - - - - - - - - - -|
|- - - - - - - - - - - - - - - - - - - -|
|- - - - - - - - - - - - - - - - - - - -|
|- - - - - - - - - - - - - - - - - - - -|
|- - - - - - - - - - - - - - - - - - - -|
|- - - - - - - - - - - - - - - - - - - -|
|- - - - - @ @ @ - - - - - - - - - - - -|
|- - @ @ - - - @ @ - - - - - - - - - - -|
|- - @ @ - - - @ @ - - - - - - - - - - -|
|- - - - - - - - - - - - - - - - - - - -|
|- - - - @ - - - - - - - - - - - - - - -|
|- - - - @ - - - - - - - - - - - - - - -|
|- - - - @ - - - - - - - - - - - - - - -|
|- - - - - - - - - - - - - - - - - - - -|
|- - - - - - - - - - - - - - - - - - - -|
|- - - - - - - - - - - - - - - - - - - -|
