100 50
|- - - - @ @ @ @ - - - - - - - - - - - @ @ @ - - @ - - - - - - - - - - - - - - - - - - - - - - - - - - - - - @ - @ - - @ @ @ @ - - - - @ - @ @ @ @ @ @ @ - - - - - @ - - - - - - - - @ - - - @ - - - - -|
|- - - - @ @ @ @ - - - - - - - - @ @ - @ @ - - - @ - - - @ @ - - - - - - - - - - - - @ @ @ - - - - - - - - - @ - @ @ @ @ @ @ @ @ @ - @ @ - - - - @ - - - - - - @ - @ - - - - - - - - @ - @ @ @ - @ - - -|
|- - - - @ @ @ @ - - - - - - - - @ @ - @ @ - - - @ - - @ @ @ - - - - - - - - - - - - @ @ @ - - - - - - - - @ @ - - @ @ - @ @ - @ @ @ @ @ - - - @ @ - - - - - - @ @ @ - - - - - @ @ @ @ - @ @ @ @ @ @ @ @|
|- - - - - - - - - - - - - @ @ @ @ @ @ @ @ - - - @ @ - @ - - - @ @ - - - @ @ @ - - - @ - - - @ @ @ @ @ @ @ @ @ - - - - - - @ @ @ @ @ @ @ @ @ @ @ @ - - - - - - @ - - - - - - - - - @ - - - - @ @ @ @ - -|
|- - @ - - - - - - - - - - - - - @ @ @ - - - - @ @ @ - @ - @ @ @ @ - - @ @ - @ @ - - - - - - @ - - @ @ - - @ @ @ @ @ - - - - @ @ @ @ @ @ @ - - - - - - - - - - - - - - - @ @ - @ @ @ - - - - - @ @ @ - -|
|- - @ @ - - - - - - - - @ - - - @ @ @ @ @ @ - @ @ - - - - @ @ - - - - @ @ - @ @ @ @ - - - - @ - - - - - @ @ - - @ @ - - @ @ @ @ @ @ - - - - - - - - - - - - - - - - - - @ @ @ @ @ @ - @ @ - - - @ @ @ @|
|@ @ @ @ - - - - - - - - @ - @ @ @ - - - - - - @ @ @ @ @ - - - - - @ @ @ - - - - - - - - - - @ - - - - - @ @ - - @ - - - @ @ - - - - - @ @ @ - - - - - @ - - - - - - - - - - @ @ @ @ @ @ @ @ @ @ @ - @ @|
|- - - @ - - - - - @ @ @ @ - - - - - - @ @ - - - - @ @ @ - - - - - - - - - - - - - - @ - - - @ @ @ @ - @ @ @ - @ @ @ - - - - - @ @ - - @ @ @ @ @ @ - - @ @ @ @ - - - - @ - - - - @ - - - - - - @ @ @ @ @|
|@ @ - - - - - - - - - - - - - - - - - @ @ - @ @ @ @ - @ - - - @ @ @ - - - @ @ - - - @ - - @ @ - - @ @ @ - @ - @ @ @ - - - - - @ @ - @ @ @ - @ - - - - @ - @ @ - - - - @ @ @ - - @ @ - - - - - @ - @ @ @|
|- - - - - - - - - - - - - - @ @ - - @ @ @ @ @ - - - - @ - - - - - - - - - @ @ - - - @ - - @ - - - @ @ @ @ @ @ @ - @ - @ - - - - @ @ @ @ - - @ - - - - @ @ @ @ - - - - @ @ @ - @ @ @ - - - - - @ - @ @ @|
|- - - - - - - - - - - @ @ @ @ @ @ @ @ - - - - - - - - @ @ @ - - - - - - - - - - @ @ @ @ @ @ - - - @ @ @ @ - - - - - - @ @ @ @ @ @ @ - - - - @ - - - - @ @ @ @ @ - - - @ @ @ - @ @ @ @ - - @ - @ @ @ - @|
|@ @ @ @ @ @ @ - - - - @ @ - - - @ @ - - - - @ @ - - - - - - - - - - - - - - - - @ @ - @ @ - - - - - - @ @ - - - - @ @ @ @ @ @ @ @ @ - - - - @ @ - - - - - - - @ @ @ @ @ - - - - - - @ - @ @ - - @ @ @ @|
|- - - - - - @ @ @ @ @ @ - - - @ @ @ - - - - @ @ - - - - - @ @ @ - - @ @ @ - - - @ @ @ @ @ @ - @ @ @ - - - - - - @ @ @ @ - @ @ @ @ - - - - - - @ - - - - - @ @ @ @ @ @ - - @ @ @ - - @ - @ @ - - @ - @ @|
|- - - - @ @ @ @ @ @ @ - - - - @ @ - - - @ @ @ @ @ - - @ @ @ @ @ - - - - @ @ @ @ @ @ - - - @ @ @ - - - - - - - - @ @ @ @ @ @ @ @ - - - - - - - @ - @ - @ @ @ @ @ @ @ @ - @ @ @ @ @ @ @ @ @ - - - - - @ @|
|- - - - @ @ - - @ - - - - - @ @ @ - - - - - @ - @ - - @ @ - @ @ - - - - - - - - - @ - - - - @ @ @ @ - - @ @ @ - - @ @ @ @ - - @ @ - - - - - - - - @ - @ @ @ @ - @ @ @ - - - - - @ @ @ @ - - - - - - - -|
|- - - - @ @ @ @ @ @ @ @ @ - @ @ - - - - - - @ - @ @ @ @ - - @ - - @ @ - - @ @ - - - - - - @ @ @ - - - - - - - - @ @ - - - - - @ @ - - @ @ @ - - - @ @ @ @ @ @ - - - - - - - - - - @ @ @ @ - - - - - @ @|
|- - - - @ - - @ @ - - - @ @ @ @ @ - - - - - @ - - @ @ - - - @ - - @ @ - - @ @ @ @ @ @ @ - @ - - - @ - @ - - - - @ @ - - @ @ - @ @ - - - - - - - - - @ - @ - - - - - @ @ - - - @ - - - - - - - - - - @ @|
|- - - - @ - - @ @ @ @ @ @ @ @ @ @ - - - @ - - - @ @ @ - - @ @ - - - - - - @ @ - - - @ @ @ @ @ @ @ @ - @ - - - @ @ - - - @ @ @ @ @ - - - - - @ @ @ - @ @ @ - - - - - @ @ @ @ - @ - - @ @ - - @ - @ @ @ @|
|@ @ @ @ @ - - - - @ - @ @ @ @ @ - - - - @ - @ @ @ - @ @ @ @ @ - - - - - - @ @ - - - @ @ @ - - - @ @ - @ @ @ - @ @ @ @ - @ @ @ - - - - - - - @ - - - @ @ - - - - - - - - - - - @ - - @ @ - - @ - - - - -|
|@ @ @ @ @ @ @ @ - @ - @ - - - @ @ - - - @ - - @ - - @ @ @ - @ @ - @ @ @ - - - - @ @ @ @ @ @ @ - - - - - @ @ @ @ @ @ @ - @ - @ - - @ @ @ - - @ - - - - - - - @ - - - - - - - - - - - - - - - @ - - - @ @|
|- - - - @ @ @ @ - @ - @ - - - @ @ - - - - - - @ @ @ @ @ @ - @ @ - - - @ @ @ - - - - @ @ - - - - - - @ - - - - - - - - - @ @ @ - - - - - - - - - - - - - - - @ - - - - - - - - @ @ @ @ @ - - - - @ - @ @|
|- - - - @ - @ @ - - - @ @ - - - - - @ @ - - - @ @ - @ - - - - - - - - - - - - - - - - @ @ - - @ @ @ @ - - @ @ - - - - - - @ - - - - - - - - - - - - - - - - @ - - - - - @ - - - @ @ @ - - - - - @ - @ -|
|- - @ - @ @ @ - - - - @ @ - - - @ @ @ @ - @ @ @ - - @ - - - - - - - - @ @ @ @ - @ - - @ @ - - @ @ - @ - - @ @ - - - - - - @ @ @ @ @ @ @ @ - - - - - - - - - - - - - - - @ - - - - - - - - - - @ @ - - -|
|- - @ - @ @ @ - - - - @ @ @ - - - - - - - @ @ @ - - - - - @ @ - - - - @ @ @ @ - @ - - @ - - - @ @ - - - - - - - - - - @ @ @ @ - - - - - - - - - - - - - - - @ @ @ - - - @ @ @ @ @ - @ - - - - @ - - @ @|
|- - @ - - - - - - - - - @ @ @ - @ @ @ - - - - - - @ @ @ @ @ @ @ @ @ @ @ @ - - - @ - - - - - - @ @ - - @ @ @ - - - - - - - - @ @ @ - - - - - - - @ @ @ @ @ @ @ @ - - - @ @ @ @ @ @ - @ - - - @ @ - - @ @|
|- - - - - - - - - - - - - - @ @ @ @ @ - - - - - - @ @ @ @ - @ - - - - - - - - - @ - - - - - - @ @ - - - - - - @ @ - - - - @ @ @ - - @ @ - - - - - - - - - - - @ @ @ - - - - - - @ - @ - @ - @ @ - - - -|
|- - - - - - @ @ @ @ @ - - @ @ @ - - - - - - - - - - - @ - - - - - - - - - - - - @ - - @ @ - - - - - @ @ - - - @ @ - - - - - - - - - @ @ - - - - - - - - - - - @ @ @ @ @ @ @ - - - - @ - @ - @ @ - - @ @|
|@ @ @ @ @ @ @ @ @ @ - - - - - @ @ @ @ @ @ @ @ @ - - - @ - - @ @ @ @ - - - - - - - - - @ @ @ @ @ - - @ @ - - - - - - - - - - - - - - - - - - - - - - @ - - - @ @ @ - @ @ @ @ - - - - @ - @ - - @ - - @ @|
|- @ @ - - - @ @ @ @ @ @ - - - - @ @ @ - - @ @ - - - @ @ @ @ @ - - - - - - - @ - - - - - - - @ @ - - - @ @ @ @ - @ @ - - - - - - - - @ @ - - - - - - @ @ @ - @ @ @ - - @ @ @ @ - - - - - - - - - - - - -|
|- @ @ - - - - @ - - - @ @ @ @ - - @ @ - - @ @ - - - @ @ @ @ @ - - - - - - - @ @ - - - - @ @ @ @ - @ @ @ @ @ @ - @ @ - - - - @ @ - - @ @ @ - - - - - @ - @ @ @ @ @ @ @ @ - @ @ @ - - - - - - - @ @ - @ @|
|@ @ @ @ - @ - @ - - - - - - @ @ - @ @ @ - - @ - - - @ - - - - - - - - - - - @ @ - - - - @ - @ @ - - @ @ @ - - - - - - - - - @ @ - - - - @ - - - - - - - - @ @ @ - - @ - - - - @ @ @ - - - - - @ @ - @ @|
|@ @ @ @ - @ - @ @ - - - - - @ @ - @ - @ @ @ @ @ - @ @ - - - - - - - - - - - @ @ @ @ @ - @ - @ @ - - - - @ - - - - @ @ - - - - @ @ @ - @ @ @ - - - @ @ - - @ @ @ - - @ - - @ @ @ - - - - @ @ @ @ @ - - @|
|- @ @ - - @ - - @ - @ @ @ @ @ @ @ @ @ @ @ @ @ @ - @ @ @ @ @ - @ - - - - - - @ @ @ @ @ - - - @ - - - - - @ @ @ @ - @ @ - - - - - @ @ @ @ @ @ - - - @ @ - - - - - - - @ - - - - - - @ @ @ @ @ @ @ @ @ - @|
|- @ @ @ - - - - @ @ @ - - @ - - - - - - @ @ @ @ - @ - - - - - @ - - - @ - - @ - @ @ - - - - @ - - - - - @ - - - - @ @ - - - - - @ @ @ @ @ @ @ - - - @ @ @ @ @ - - @ @ @ @ @ - - - - - - - - @ @ - @ @ @|
|- @ - @ - - @ - @ @ @ - @ @ @ - - - - - @ @ @ @ - - - - - - - @ - - - @ - @ @ @ @ @ @ @ - - - - - @ @ @ @ @ @ - - - - - - @ - @ @ - @ @ @ - - - - - - @ - - - - @ @ - - - @ @ - - - - - - - @ @ - @ @ -|
|- @ @ @ @ @ @ - - - - - @ @ @ - - - - - @ @ - - - - - - - - - @ @ @ @ @ - - - - @ @ @ @ - - - - - @ @ - - - - - - - - - - @ - @ @ - - - @ - @ - @ - - @ - @ - - @ @ - @ @ @ @ - - - - - - - - @ @ @ - -|
|- @ - - - - @ - - - - - - - @ - - - @ @ @ @ - - - - - @ @ @ @ @ - - @ @ @ @ - - - - - @ @ - @ @ - @ @ @ @ - - - @ @ - - - @ - - - - - - @ - @ - @ - - - - @ - - @ @ - @ - - - - - - - - - - - @ @ @ - -|
|- - - - @ @ @ @ @ - - @ - - @ @ @ - @ @ @ - - - - - - @ @ - @ @ - - - - @ @ - - @ @ @ @ @ - @ @ - - @ - - - - - @ @ - - - - - - - @ @ - - - @ - @ - - @ - @ - - - - - @ - - @ - @ - - - @ @ @ @ - - - -|
|- - @ @ @ @ @ @ @ @ @ @ - - @ @ @ - - @ @ - - - - - - @ @ @ @ @ @ - - - @ - - - @ @ @ - @ @ @ @ - @ @ @ @ @ - - - @ @ @ @ - - - - @ @ - - @ @ - - - - @ @ @ @ - - - - @ @ @ @ - @ @ @ - @ - - @ @ @ @ @|
|- - - - - - @ - - @ @ @ - - @ - - - - - - - - - - - - @ - @ @ @ @ - - - - - @ @ @ - @ @ @ @ - @ @ @ @ - @ @ @ - - - - - @ - - - - - @ - - @ @ @ @ @ @ @ @ @ @ - - @ @ @ - - @ - @ @ @ @ @ - - - - @ @ @|
|- - - - - - @ @ @ @ @ - - - - - @ @ @ - - - - - - - - @ - - - - @ - - - - - @ - @ @ @ - - - - - - @ @ - - - - - - - - - @ - - - - - @ - - - @ @ @ - - - - - - - - @ - - - - - - @ - @ @ - - - - - @ - -|
|- @ @ @ @ @ @ @ - @ @ @ @ @ - @ @ @ @ @ @ - @ - - - - - - - @ - @ - - - - - @ - - @ @ @ - - - - - - @ - - - @ @ @ @ @ @ @ - - - - @ @ - - - - - @ @ @ @ @ - - - - @ - - - - - - @ - - @ @ - - - - @ - @|
|@ @ - - - - @ @ @ @ @ @ @ - - - - - - @ @ - @ - - - - @ @ - @ - - - - - - - @ - @ @ @ @ - @ @ - - - @ - - - @ @ - - @ @ @ @ @ - @ @ @ @ - - - - - @ @ - - - - - - - - - - - - - @ - @ @ @ - - @ @ @ - @|
|@ @ - - - - @ - - @ @ - @ @ @ - - - - @ - - @ @ @ - - @ @ - @ - - - - - @ - @ - @ @ @ @ - @ @ - - - @ - - - - - - @ @ @ @ - - - @ - - @ - - - - @ @ - - - - - - - - @ - - - @ - - - @ - @ - - @ @ @ - -|
|- - - - - - @ - - - - - - @ @ - - - - @ @ @ @ @ @ - - @ @ - - - - - @ @ @ - @ - - - @ @ @ @ @ @ @ - - - - - - - @ @ @ - - - - - @ - - @ @ @ - - @ - - - - - - - - - @ - - - @ - - - @ - @ @ - - @ @ - -|
|- - - - - - @ - - - - - - - @ - - - - - @ @ - - - - @ @ @ - - @ @ @ @ @ @ - - - - - @ - @ - @ @ - - @ @ @ @ @ - @ @ @ @ @ - - - @ - - - @ @ - - @ @ @ @ - @ @ - - - @ @ @ @ @ @ @ @ @ - @ @ - - @ - - -|
|@ @ - - - - @ - - - @ @ - - @ - - - - - - - - - @ - @ @ @ - - @ - - - @ @ - @ @ @ @ @ @ @ - @ @ @ @ @ - - - - - @ @ @ - - - - - - - - - - - - - - - - @ @ @ @ @ @ - @ @ - - - - - - - - - - - - @ - - -|
|@ @ @ @ - - @ - - - @ @ - - @ - - - - - - - - @ @ - - @ - - - @ - - - @ @ @ @ @ @ @ @ @ - - - - - - @ - - - - - - - - - - - - - - - @ @ - - - - - - - @ @ @ @ @ @ - @ @ @ @ @ @ @ - - - - - - @ @ @ - -|
|@ @ @ @ - - @ - @ @ @ @ @ @ @ - - @ @ - - - @ @ @ - - - - - @ @ @ - - - @ @ @ @ - - @ @ - - - - - - @ - - - - - - - - @ @ @ @ - - - @ @ @ - - - - - - @ - - - @ @ - - - - - - - - - - @ @ @ - - - @ - -|
|- - @ @ - - - - - - - - @ @ @ - - @ @ @ - - - @ @ @ - - - - - - - - - - @ - @ - - - - - - @ @ @ - - @ - - - - - - - @ @ - @ @ - - - @ @ @ - - @ @ - - - - - - @ @ - - - - - - - - - - - - - - - - @ @ @|
