100 50
|@ @ - - - - - - - - - - - - - - - - @ - - - - @ - - - - - - - - - - @ - - - @ @ - - - - - - - - - - - - - - @ @ @ - - - - - - - @ @ @ @ - - @ @ - - @ @ @ - - - - - - - - @ @ - - - - - - - - - - - - -|
|@ @ - - - - - - - - - - - @ @ @ - - @ - @ @ - @ - - @ @ - - - - - - @ - - - @ @ - - - - - - - - - - - - - - - - - - - - - - - - - - - @ - - @ @ @ @ @ - - - - - - - - - - @ @ - - - - - - - - - - - - -|
|- - - - @ - - - - - - - - - - - - - @ - @ @ @ @ @ @ @ @ - - - @ @ - @ - - - - - - - - - - - - - - - - - - - - - - - - - - - - - - - - @ - - - - - - - - - - - @ @ - - - - @ @ @ - - - - - - - - - - - -|
|- - - - @ - - - - - - - - - - @ @ @ @ - - - @ - - - @ @ - - - @ @ - - - - - - - - - @ - - - - - - - - @ - - - - - - - - - - - - - - - - - - - - - @ @ @ - - - @ @ - - - - - - - - - - - - - - - - - - -|
|- - - - @ - - - - - - - - - - - - - - - - @ @ @ @ @ @ @ @ @ - @ - - - - - - - @ - - @ - - - - - - - - @ - - - - - @ - - - - - - - - - - - - @ - - @ - - - - - @ - - - - @ @ @ @ - - - - - - - - - - - -|
|- - - - - - - - - @ @ @ - - - - - - - - - @ @ @ @ @ @ - @ @ - @ - - - @ @ @ @ @ - - @ @ @ - - - - - @ @ @ - - - - @ - - - @ @ @ - - - - - - @ - - @ - - - - - @ - - - - - - @ @ - - - - - - - - - - - -|
|- - - - - - - @ @ @ @ @ - - - - - - - - - - - @ @ - - - - - - @ - - - - - - @ @ - - - @ @ - - - - - - - - - - - @ @ - - - - - - - - - - - - @ - - - - - @ @ - @ - - - - - - @ @ @ @ - - - - - - - - - -|
|@ - - - - - - @ @ @ - - - - - - - - @ @ - - - @ @ - - - - - - - - - - - - @ @ - - - - - @ @ @ - - - - - - - - - @ - - - - - - - - - - - - - - - - - - - @ @ - - - - - - - - @ - @ @ - - - - - - - - - -|
|@ - - - - - - @ @ @ - - - - - - - - @ @ - - - - - - - - - - - - - - - - - @ @ - - - - - - @ @ - - - - - - - - - @ - - - - - - - - - - - @ @ - - - - - @ @ @ - - - @ @ - - @ @ - @ @ - - - - - - - - - -|
|@ - - - - - @ @ @ @ - - - - - - - - - - - - - - - - - - - - - - @ - - - @ @ - - - - - - - - - - - - - - - - - - - - - - - - - - - - - - @ @ - - - - - @ - @ @ - - @ @ - - @ @ - - - - - - - - - - - - -|
|- - @ @ @ @ @ @ - - - - - - - - - - - - - - - - - - - - - @ @ - @ - - - @ @ - - - - - - - - - - - - - - - - - - - - - - - @ @ @ - - - - - @ - - - - - @ - @ @ @ - @ @ - - - - - - - - - - - @ @ @ - - -|
|- - - - - - - @ @ - - - - - - - - - @ @ - - - - @ @ - - @ @ @ - @ - - - @ @ @ @ - - - - - @ - - - - - - - - - - - - - - - - - - - - - - - @ - - - - - - - - - @ - - - - - - - - - - - - - - - - - - - @|
|- - - - - - - - @ - - - - - - - - - @ @ @ @ @ - @ @ - - @ @ - - - - @ @ @ @ @ @ - - - - - @ - - - - - - - - - - - - - - - - - - - - - - - @ - - @ @ @ @ - - - @ - - - - - - - - - - - - - - - - - - - @|
|- - - - - - - - @ - - - @ @ @ - - - - - - - - - - - - - - - - - - - - - @ @ - - - - - - - @ - - - - - - - - - @ - - - - - - @ @ - - - - @ @ - - - - - @ - - - - - - - - - - - - @ @ - - - - - - - - - @|
|- - - - - @ @ @ @ - - - - - @ @ @ @ - - - - - - - - - - - - - - - - - - - - - - - - - - - - - - - - - - - - - @ - - - - @ @ @ @ @ @ - @ @ @ - - - - - @ - - @ @ @ - @ - - - - - @ @ - - - - - - - - - @|
|- - - - - @ @ @ - - - - - - - - - - - @ @ @ @ @ @ - - - - - - - - - - - - - - - - - - - - - - - @ @ - - @ @ - @ - - - - - - @ @ @ @ @ @ @ @ - - - - - @ - @ @ - - - @ - - - - - - - - - - @ @ - - - - @|
|- - - @ @ @ @ - - - - - - - - - - @ - @ @ - - @ @ - - - - - - - - - - - - - - - - - @ @ - - - - @ @ - - @ @ - - - - - - - - @ @ - - @ @ - - - - - - - @ @ @ @ - - - @ - @ @ @ @ - - - - - @ @ - - - - -|
|- - - @ - - - - - - - @ @ @ - - - @ - - - - - - @ @ @ - - - - - - - - - - - @ @ @ - @ @ - - - - - - - - - - - - - - - - - - - - - - @ @ - - - - - - - @ @ @ - - - - - - - - - @ - - - - - - - - - - - -|
|- - - @ - - - - - - - @ @ @ - - - @ - - - - - - - - - - - - - - - - - - - - @ @ @ - - - - - - - - - - - - - - - - - - - - @ - - - - - @ - - - - - - - @ @ @ - - - - - - - - - @ - - - @ @ @ - - - - - -|
|- - - @ @ - - - - @ @ @ - @ - @ @ @ - - @ @ @ - - - - - - - - - - - @ @ @ @ @ @ @ - - - - - - - - @ @ - - - - - - - - @ - @ - - - - - @ - - - - - - - - - - - - - - - - - - - - - - - - - - - - - - - -|
|- - - - @ @ @ - - - - - - - - - - - - - - - - - - - - - - - - - - - - - - @ @ @ @ - - - - - - - - @ @ - - - - - - - @ @ - @ - - - - - @ - - - @ @ @ - - - - - - - - - - - - - - - - - - - - @ - - - - -|
|- - - - - - @ @ - - - - - - - - - - - - - - - - - - - - - - - - - @ @ @ - - - @ - - - - - - - - - @ @ - - - - - - - @ @ - - - - - - - - - - - - - @ @ - - - - @ @ @ @ @ @ - - - - - - - @ @ @ - @ - - -|
|- - - - - - - @ - - - - - - - - - - - - - - - - - - - - - - - - - - - - - - - @ - - - - - - - - - @ @ - - - - - - - - @ - - - - - - - - - - - - - @ @ - - - - - - - - - - - - - - - - @ @ @ @ - @ - - -|
|- - - - - - - @ - - - - - - - - - - - - - - - - - - - - - - @ @ - - @ @ @ - @ @ @ - - - - - - - - - - - @ - - - - - - - - - - - - @ - - - - - - - @ @ @ - - - - - - - - - - - - - - - @ @ - @ @ @ - - -|
|- - - - - - - - - - - - - @ @ - - - - - - - - - - - - - - - @ @ - - @ @ - - - - @ @ @ - - - - - - - - @ @ @ @ - @ @ @ - - - - - - @ - - - - - - - - - @ - - - - - - - - - @ @ @ - - @ @ - - - - - - - -|
|- - - - - - - - - - - - @ @ @ - - - - - - @ - - - - - - - - @ @ @ - - @ @ @ @ - - - - - - - - - - - - @ @ @ @ - - @ - - @ - - - - @ - - - - @ @ @ - - @ - - - - - - - - - @ @ @ - @ @ @ - - - - - - - -|
|- - - - - - - - - - @ - @ - @ - - - - - - @ - - - - - - - - - - - - - - - @ @ - - - - - - - - - - - - - - - - - - @ @ @ @ - @ @ @ @ - @ @ - @ @ - - @ @ @ - - - - @ @ @ @ @ - - - @ - @ - - - - - - - -|
|- - - - - @ @ - - - @ - @ - @ - - - - - - @ - - - - - - - - - - @ @ @ - - - - - - - - - - - - - - - - - - - - - - @ - - @ - - - - - - @ @ - - @ @ - @ - @ @ - @ @ @ - @ @ - - - - @ - @ - - - - - - - -|
|- - - - - @ @ - - @ @ - - - @ - - - - - - - - - - - - - - - - - - - - - - - - - - - - - - - - - - - - - - - - - @ @ - - - - - - - - - - - - - - @ - @ - @ @ @ @ @ @ - - - - - - - @ - @ - - - - - - - -|
|@ @ @ - - - @ - - @ @ - - - @ - - - - - - - - - - - - - - - - @ @ - - - - - @ @ - - @ @ @ - - - - - - - @ - - - @ - - - - - - - - - - - - - - - @ @ @ - - - - @ @ @ @ - - - - @ @ @ - - - @ - - - - - -|
|- - - - - - - - @ @ @ @ - - @ - - - - - - - - - - - - - - - - @ @ - - - - - @ @ - @ @ @ - - @ @ @ @ - - @ - - - @ - @ - - - - - - - - - - - - - @ @ @ - - - - - - - @ - - - - - - @ @ @ - @ - - - - - -|
|- - - - - - - - @ @ @ @ - - @ @ - - - - - - - - - - - - - - - - - - - - - - - - - - - - - @ @ - - - - - @ - - - @ - @ - - - - - - - - - - - - - @ @ - - - - - - - - @ - - - - @ - @ @ @ - @ - - - @ @ @|
|- - - - - - @ @ @ - - - - - @ @ - - - - - - - - - - - - - - - - - - - - - - - - - - - - - @ @ - - - - - - - @ @ @ - @ - - - - - - @ @ @ - - - - @ - - - - - - - - - - - - - - @ - - - @ - - - - - - - -|
|- - - - - - @ @ - - - - - @ @ - - - - - - - - - - - - - - - - - - - - - - - - @ - - - - - - - - - - - - - - - - @ - - - - - - - - - - - - - - - - - - - - - @ @ @ - - - - - - @ - - - - - - - - - - - -|
|@ @ - @ @ - - - - - - @ @ @ @ - - - - - - - - - - - - - - - - - - - - - - - - @ - - - @ @ @ @ @ @ @ - - - - - - @ - - - - - - - - - - - - - - - - - - - - - @ @ @ @ @ @ - - - - - - - - - - - - @ @ - -|
|- - - @ @ - - - - - - @ @ - - - - - - - - - - - - - - - - - - - - - - @ @ @ @ @ - - - @ @ - - - - @ @ @ - @ - - - - - - - - - - - - - - @ @ - - - - - - - @ @ @ @ @ - @ - - @ @ - - - - - - - - @ @ @ @|
|- - - - - - - - - - - @ - - - @ @ @ @ - - - - - - - - - - - - - - - - @ @ @ @ - - - - @ - - - - - - @ @ - @ @ @ - - @ @ - - - - - - - @ @ @ - - - - - - - - - - - @ @ @ - - @ @ - - - - - - - - - - - -|
|- - - - - - - - - - - - - @ - @ @ @ @ - - - - - - - - - - - - - - - - - - @ @ - - - - - - - - - - - - - - @ @ @ - - @ @ - - - - - - @ @ - - - - - - @ - - - - - - - - - - - - - - - - - - - - - - @ - -|
|- - - - - - - - @ @ @ - - @ - - - @ @ - - - - - - - - - - - - - - - - - - - - - - - - - - - - - - - - - @ @ - - - - - - - - - - - - @ @ - - - - - - @ - - - - - - - - - - - - - - - - - - - - - - @ - -|
|- - - - - - - - - - - - - @ - - - - - - - - - @ @ - - @ @ @ - - - - - - - - - - - - - - - - - - - - - - @ @ - - - - - - - - - - - - - - - - - - - - @ - - - - - - - - - - - - - - - - - - @ @ @ - @ - -|
|- - - - - - - - - - - - - @ - - - - - - - - - @ @ @ @ @ - - - - - @ @ - - - - - - - - - - - - - - - - - @ @ @ @ @ - - - - - - - - - - - - @ - - - - - - - - - - - - - - - - - - - - - - - - @ - - @ - -|
|- - - - - @ @ @ @ - @ @ @ @ - - - - - - - - - - @ @ @ @ - - @ @ @ @ @ - - - - - - - - - - - - - - - - - @ @ - @ @ - - - - - - - - - - - - @ @ @ @ - - - - - - - - - - - - - - - - - - - @ @ @ @ - @ - -|
|- - - - - @ @ - - - - - - - - - - - - - - - - - - - @ @ - - - - - - - - - - - - - - - @ @ @ - - - - - - - - - - - - - - @ @ @ @ - - - - - @ - - - - - - - - - - @ - - - - - @ @ @ - - @ @ @ - @ @ @ - -|
|- - - - - - - - - - - - - - - - - - - - @ - - - - - - - - @ @ - - - - - - - @ - - - - - - - - @ @ - - - @ @ - - - - - - - - @ @ - - - - - - - - - - - - - - - - @ - - @ @ @ @ - - - - - - - - @ @ - - -|
|- - - - - - - - - - - @ @ @ - - - - - - @ - - - - - - - - @ @ - - - - - - - @ - - - - - @ @ @ @ @ - - - @ @ - @ @ @ - - - - @ @ @ - - - - - - - - - - - - @ @ - @ - - @ - - - - - - - - - - - - - - @ @|
|@ @ - - - - - - - @ @ @ - - - - - - - - @ - - - - - - - - - - - - - - - @ - @ - - - - - @ @ @ - - - - - - - - - - @ @ @ @ - - - - - - - - - - - - - - - - @ @ - - - - @ - - - - - @ @ @ - - - - - - - -|
|@ @ @ - - - - - - @ @ - - @ @ - - - - - - - - - - - - - - @ @ - - - - - @ - @ @ - @ - - - - @ @ - - - - - - - - - @ - - @ - - - - - - - - - - - - - - - - - - - - - - - - - - @ @ @ @ @ - - - - - - - -|
|@ @ @ - - - - - - - - - - @ @ - - - @ - - - - - - - - - - @ @ - - - - - @ - @ @ - @ - - - @ @ @ - - - - - - - - - @ - @ @ - - - - - - - - - - - - - - - - - - - - - - - - - - @ @ @ - - - - - - - - - -|
|- - - - - - - - - - - - - - - - @ @ @ - @ @ @ - - - - - - - - - - @ @ - - - - - - @ - - - @ @ @ - - - - - - - - - - - @ @ - - - - - - - - @ @ - - - - - - - - - - - - - - - - - - - - - - - - - - - - -|
|- - - - - - - - - - - - - - - - - - @ - @ @ @ - - - - - - - - - - @ @ - - - - - - @ @ - - @ @ @ - @ @ @ - - - - - - - - - - - - - - - - - @ @ - - - - - - - - - - - - - - - - - - - - - - - - - - - - -|
