20 200
|- - - - - - - - - - - - - - - - - - - -|
|- - - - - - - - - - - - - - - - - - - -|
|- - - - - - - - - - - - - - - - - - - -|
|- - - - - - - - - - - - - - - - - - - -|
|- - - - - - - - - - - - - - - - - - - -|
|- - - - - - - - - - - - - - - - - - - -|
|- - - - - - - - - - - - - - - - - - - -|
|- - - - @ - - - - - - - - - - - - - - -|
|- - - - @ - - - - - - - - - - - - - - -|
|- - - - @ - - - - - - - - @ - - - - - -|
|- - - - - - - - - - - - - @ - - - - - -|
|- - - - - - - - - - - - - @ - - - - - -|
|- - - - - - - - - - - - - - - - - - - -|
|- - - - - - - - - - - - - - - - - - - -|
|- - - - - - - - - - - - - - - - - - - -|
|- - - - - - - - - - - - - - - - - - - -|
|- - - - - - - - - - - - - - - - - - - -|
|- - - - - - - - - - - - - - - - - - - -|
|- - - - - - - - - - - - - - - - - - - -|
|- - - - - - - - - - - - - - - - - - - -|
|- - - - - - - - - - - - - - - - - - - -|
|- - - @ @ - - - - - - - - - - - - - - -|
|- - - @ @ - - - - - - - - - - - - - - -|
|- - - - - - - - - - - - - - - - - - - -|
|- - - - - - - - - - - - - - - - - - - -|
|- - - - - - - - - - - - - - - - - - - -|
|- - - - - - - - - - - - - - - - - - - -|
|- - - - - - - - - - - - - - - - - - - -|
|- - - - - - - - - - - - - - - - - - - -|
|@ - @ - - - - - - - - - - - - - - - - -|
|@ - @ - - - - - - - - - - - - - @ @ @ -|
|@ - @ - - - @ - - - - - - - - - - - - -|
|- - - - - - @ - - - - - - - - - - - - -|
|- - - - - - @ - - - - @ @ - - - - - - -|
|- - - - - - - - - @ @ @ @ - - - - - - -|
|- - - - - - - - - @ @ - - - - - - - - -|
|- - - - - - - - - - - - - - - - - - - -|
|- - - - - - - - - - - - - - - - - - - -|
|- - - - - - - - - - - - - - - - - - @ @|
|- - - - - - - - - - - - - - - - - - @ -|
|- - - - - - - - - - - - - - - - - - @ -|
|- - - - - - - - - - - - - - - - - - @ -|
|- - - - - - - - - - - - - - - - - - - -|
|- - - @ - - - - - - - - - - - - - - - -|
|- - - @ - - - - - - - - - - - - - - - -|
|- - - @ - @ @ - - - - - - - - - - - - -|
|- - - - - @ @ - - - - - - - - - - - - -|
|- - - - - - - - - - - - - - - - - - - -|
|- - - - - - - - - - - - - - - - - - - -|
|- - - - - - - - - - - - - - - - - - - -|
|- - - - - - - - - - - - - - - - - - - -|
|- - - - - - - - - - - - - - - - - - - -|
|- - - - - - - - - - - - @ @ @ - @ @ @ -|
|- - - - - - - - - - - - - - - - - - - -|
|- - - - - - - - - - - - - - - - - - - -|
|- - - - - - - - - - - - - - @ - - - - -|
|- - - - - - - - - @ - - - - @ - - - - -|
|- - - - - - - - - @ - - - - @ - - - - -|
|- - - - - - - - - @ - - - - - - - - - -|
|- - - - - - - - - - - - - - - - - - - -|
|- - - - - - - - - - - - - - - - - - - @|
|- - - - - - - - - - - - - - - - - - - @|
|- - - - - - - - - - - - - - - - - - - -|
|- - - - - - - - - - - - - - - - - - - -|
|- - - - - - - - - - - - - - - - - - - -|
|- - - - - - - - - - - - - - - - - - - -|
|- - - - - - - - - - - - - - - - - - - -|
|- - - - - - - - - - - - - - - - - - - -|
|- - - - - - - - - - - - - - - - - - - -|
|- - - - - - - - - - - - - - - - - - - -|
|@ - - - - - - - - - - - - - - - - - - -|
|@ - - - @ @ @ - - - - - - - - - - - - -|
|@ - - - - - - - - - - - - - - @ - - - -|
|- - - - - - - - - - - - - - - @ - - - -|
|- - - - - - - - - - - - - - - @ - - - -|
|- - - - - - - - - - - - - - - - - - - -|
|- - - - @ - - - - - - - - - - - - - - -|
|- - - - @ - - - - - @ - @ - - - - - - -|
|- - - - @ - - - - - @ - @ - - - - - - -|
|- - - - - - - - - - @ - @ - - - - - - @|
|- - - - - - - @ - - - - - - - - - - - @|
|- - - - - - - @ @ @ @ @ - - - - - - - -|
|- - - - - - - @ @ - - - - - - - - - - -|
|- - - - - - - - @ - - - - - - - - - - -|
|- - - - - - - - - - - - - - - - - - - -|
|- - - - - - - - - - - - - - - - - - - -|
|- - - - - - - - - - - - - - - - - - - -|
|- - - - - - - - - - - - - - - - - - - -|
|- - - - - - - - - - - - - - - - - - - -|
|- - - - - - - - - - - - - - - - - - - -|
|- - - - - - - - - - - - - - - - - - - -|
|- - - - - - - - - - - - - - - - @ @ @ -|
|- - - - - - - - - - - - - @ @ - - - - -|
|- - - - - - - - - - - - - @ @ - - - - -|
|- - - - - - - - - @ - - - - - - - - - -|
|- - - - - - - - - @ - - - - - - - - - -|
|- - - - - - - - - @ - - - - - - - - - -|
|- - - - - - - - - - - - - - - - - - - -|
|- - - - - - - - - - - - - - - - - - - -|
|- - - - - - - - - - - - - - - - - - - -|
|- - - - - - - - - - - - - @ @ - - - - -|
|- - - - - - - - - - - - - @ @ - - - - -|
|- - @ @ - - - - - - - - - - - - - - - -|
|- - @ @ - - - - - - - @ - - - - - - - -|
|- - - - - - - - - - - @ - - - - - - - -|
|- - - - - - - - - - - @ - - - - - - @ @|
|- - - - - - - - - - - - - - - - - - @ @|
|- - - - - - - - - - - - - - - - - - - -|
|- - - - - - - - - - - - - - - - - - - -|
|- - - - - - - - - - - - - - - - - - - -|
|- - - - - - - - - - @ @ - - - @ @ - - -|
|- - - - - - - - - - @ @ - - - @ @ - - -|
|- - - - - - - - - - - - - - - @ @ - - -|
|- - - - @ - - - - - - - - - - @ @ - - -|
|- - - - @ - - - - - - - - - - - - - - -|
|- - - - @ - - - - - - - - - - - - - - -|
|- - - - - - - - - - - - @ @ @ - - - - -|
|- - - - - - - - - - - - - - - - - - - -|
|- - - - - - - - - - - - - - - - - - - -|
|- - - - - - - - - - - - - - - - - - - -|
|- - - @ - - - - - - - - - - - - - - @ @|
|- - - @ - - - - - - - - - - - - - - - -|
|- - - @ - - - - - @ @ - - - - - - - - -|
|- - - - - - - - - @ @ - - - - - - - - -|
|- - - - - - - - - - - - - - - @ - - - -|
|- - - - @ @ @ @ - - - - - - - @ - - - -|
|- - - - @ - - - - @ @ @ - - - @ - - - -|
|- - - - @ - - - - - - - - - - - - - - -|
|- - - - - - - - - - - - - - - - - - - -|
|- - - - - - - - - - - - - - - - - - - -|
|- - - - @ @ - - - - - - - - - - - - - -|
|- - - - @ @ - - - - - - - - - - - - - -|
|- - - - - - - - - - - - - - - - - - @ @|
|- - - - - - - - - - - - - - - - - - - -|
|- - - - - - - - - - - - - - - - - - - -|
|@ @ - - - @ @ - - - - - - - - - - - - -|
|@ @ - - - @ @ - - - - - - - - - - @ @ @|
|- - - - - - - - - - - - - - - - - - - -|
|- - - - - - - - - - @ - - - - - - - - -|
|- - - - - - - - - - @ - - - - - - - - -|
|- - - - - - - - - - @ - - - - - - - - -|
|- - - - - - - - - - - - - - - @ @ @ - -|
|- - - - - - - @ - - - - - - - - - - - -|
|- - - - - - - @ - - - - - - - @ @ - - -|
|- - - - - - - @ - @ - - - - - @ @ - - -|
|- - - - - - - @ - @ - - - - - - - - - -|
|- - - - - - - @ @ @ - - - - - - - - - -|
|- - - - - - - @ - - - - - - - - - - - -|
|- - - - - - - - - - - - - - - - - - - -|
|- - - - - - - - - - - - - - - - - - - -|
|- - - - - - - - - - - - - - - - - - - -|
|@ @ - - - - - - - - - - - - - - - - - -|
|- - - - - - - - - - - - - - - - - - - -|
|- @ - - - - - - - - - - - - - - - - - -|
|- @ - - - - @ @ - - - - - - - - - - - -|
|- @ - - - - @ @ - - - - - - - - - - - -|
|- - - - - - - - - - - - - - - - - - - -|
|- - - - - - - - - @ @ - - - - - - - - -|
|- - - - - - - - - @ @ - - - - - - - - -|
|- - - - - - - @ @ @ - - - - - @ @ @ - -|
|- - - - - - - - - - - - - - - - - - - -|
|- - - - - - - - - - - - - - - - - - - -|
|- - - - - - - - - - - - - - - - - - - -|
|- - - - - - - - - - - - - - - - - - - -|
|- - - - - - - - @ - - - @ - - - - - - -|
|- - - - - - - - @ - - - @ - - - - - - -|
|- - - - - - - - @ - - - @ - - - - - - -|
|- - - - - - - - - - - - - - - - - - - -|
|- - @ @ @ - - - - - - - - - - - - - - -|
|- - - - - - - - - - - - - - - - - - - -|
|- - - - - - - - - - - - - - - - - - - -|
|- - - - - - - - - - - - - - - - - - - -|
|- - - - - - - - - - - - - - - - - - - -|
|- - - - - - - - - - - - - - - - - - - -|
|- - - - - - - - - - - - - - - - - - - -|
|- - - - - - - - - - - - - - - - - - - -|
|- - - - - - - - - - - - - - - - - - - -|
|- - - - - - - - - - - - - - - - - - - -|
|- - - - - - - - - - - - - - - - - - - -|
|- - - - - - - - - - - - - - - - - - - -|
|- - - - - - - - - - - - - - - - - - - -|
|- - - - - - - - @ @ @ - - - - - - - - -|
|- - - - - - - - - - - - - - - - - - - -|
|- - - - - @ - - - - - - - - - - - - - -|
|- - - - - @ - - - - - @ @ - - - - - - -|
|- - - - - @ - - - - - @ @ - - - - - - -|
|- - - - - - - - - - - - - - - - - - - -|
|- - - - - - - - - - - - - - - - - - - -|
|- - - - - - - - - - - - - - - - - - - -|
|- - - - - - - - - - - - - - - - - - - -|
|- - - - - - - - - - - - @ - - - - - - -|
|- - - - - - - - - - - - @ - - - - - - -|
|- - - - - - - - - - - - @ - - - - - - -|
|- - - - - - - - - - - - - - - - - - - -|
|- - - - - - - - - - - - - - - - - - - -|
|- - - - - - - - - - - - - - - - - - - -|
|- - - - - - - - @ @ - - - - - - - - - -|
|- - - - - - - - @ @ - - - - - - - - - -|
|- - - - - - - - - - - - - - - - - - - -|
|- - - - - - - - - - - - - - - - - - - -|
