30 30
|- - - - @ @ @ @ - - - - - @ @ @ - - - - - - - - - - - - - -|
|- @ - - - @ - @ - - - - - @ @ @ @ @ @ - - - - - - - - - - -|
|- @ - - - @ - @ @ @ - @ @ @ @ - - - @ @ - - - - - - - - - -|
|@ @ - - - - - @ - - - @ @ @ @ - - - @ @ - - - @ @ @ - - - -|
|@ @ @ @ @ @ - @ - - - - - - @ - - - - - - - - - @ @ @ @ @ @|
|@ @ @ @ @ @ @ @ - - - - - @ @ - - - - - - - - - @ @ @ @ - @|
|@ @ @ - @ @ @ - - - @ @ @ @ @ - - - @ @ @ - - @ @ @ - - - -|
|@ @ @ @ @ @ @ - @ @ @ - - - @ - - - @ @ @ - - @ @ @ @ - @ -|
|@ - - @ @ @ @ @ @ @ @ - - @ @ @ - - - - @ - - @ @ - - - @ -|
|- - - - @ @ @ - @ @ @ - - - - - - - - - @ - - - - - @ @ @ @|
|- - @ - - - - - @ @ @ @ - - - - - - - - @ - - - - - @ @ - @|
|- - @ - @ @ @ - @ @ @ @ - - - - - - @ - - - - - - - @ @ - @|
|- - @ - - - - - @ @ @ @ @ @ - @ @ @ @ - - - - - - - @ @ - -|
|- - - - - - - - - - - @ - - - @ - @ @ - - @ @ - - - - - - -|
|@ @ - - @ @ @ @ - - - @ @ @ - @ - @ - - - @ @ - - - - - - -|
|- @ @ - - @ @ - - @ @ @ @ @ - - - - - - - - @ @ @ - @ - - -|
|@ @ @ - @ @ @ @ @ @ @ - - - - - - - - - - - - - - - @ - - -|
|- @ @ - @ - - @ @ @ - - - - @ @ @ - - - - - @ @ @ - @ - - -|
|- @ - - @ - - @ - - - @ @ @ @ - - - - - - - - @ @ @ @ @ @ @|
|- @ - - @ @ @ @ - - - - - @ - - - - - - @ - - - - @ @ @ @ @|
|- - - - - - - - - - - - - @ @ @ @ - @ - @ - - - - - - - - @|
|- - - - @ - @ @ @ @ - - - @ @ @ - - @ - @ @ - - - @ @ @ - @|
|- - - - @ - - - @ @ - - - @ @ @ @ @ @ @ @ @ @ - - - - @ @ @|
|- @ - - @ @ @ @ @ @ - - - @ - @ @ @ @ @ - - - - - - - @ @ @|
|- @ - - @ @ @ @ @ @ @ @ @ @ @ @ @ @ - - - @ @ @ - - - - - @|
|- @ @ @ @ @ @ @ @ @ - - @ - @ - @ @ - @ @ @ - - - - - - - -|
|- - - - - - - - - - - - @ @ @ - - - - @ @ @ @ @ - - @ @ - -|
|@ @ - - - - - - - - - - - @ @ - - - - - @ @ @ @ - - @ @ @ -|
|@ - - @ @ @ - - - - - - - @ @ - - - - - @ @ @ @ - - - - @ -|
|@ - - - - - - @ @ - - - - @ @ - - - - - @ @ @ - - @ @ - @ -|
