10 10
|@ - - - - - - - @ @|
|@ @ - @ - - - - @ @|
|- @ - @ @ @ @ @ @ -|
|- @ - @ - - - @ @ @|
|- @ @ @ @ - - - - @|
|- - - - - - - - - @|
|- - - - - - - @ @ @|
|- @ @ @ - - - - - -|
|@ @ @ @ - - - - - -|
|- - @ @ - - - - - @|
