100 100
|- @ @ - - @ @ - - - - @ - - - - - - - @ - - - - - - @ @ - - @ @ - - - - - - - - - - - - - - - - @ - - - - - - - - - - - - - @ @ - - - - - @ - - - - - - - - - - - @ - - - - - @ @ @ - - - - - - @ @ - -|
|- @ @ - - @ @ @ @ @ @ @ @ @ - - - - - @ @ @ @ @ @ - @ @ @ @ @ @ - - - - - @ - - - - - - - - - - @ @ @ @ @ @ - - - - - - @ @ @ @ @ - - - - @ - - - - - - - - - - - @ - - - - - - @ - - - @ @ @ - @ @ - -|
|- - @ - - @ @ @ @ @ @ - - @ @ @ - - @ @ - - @ - - - - - @ @ - - - - @ @ @ @ - @ @ @ @ - - - - - @ - - @ @ @ @ @ - - @ @ @ @ @ - @ @ - - - - - - - - - - - - - - @ @ - - - @ @ @ @ @ @ - - - - - - - - -|
|- - @ - - @ @ @ - @ @ @ - - - @ @ @ @ - - - @ - - - @ @ @ @ - - - - - - - @ - - - - - - - - @ @ @ - - - - @ @ @ @ - @ @ - - @ @ @ @ - - - - - - - - - - @ @ @ - @ - - - - @ @ - - - @ - - - - - - @ @ @|
|- @ @ - - @ - @ - - - - - - - - @ @ - - - - @ @ @ @ @ - - - - - - - - - @ @ - - - - - - - - - - - - - - - @ @ @ @ - - - - - - @ @ - - - - - - - - - - - - @ @ @ @ @ @ - @ @ @ @ @ @ @ - - - - - - - - -|
|@ @ - - - - - @ - - - - - - - @ @ - - - - - - @ - - @ @ @ @ @ @ - - @ @ @ @ - - - - - - @ @ @ - - - - - - @ - - - - - - - @ @ @ @ - - - - - - - - - - @ @ @ - - @ - @ @ @ @ - - - - - - - - - - - - @ @|
|@ @ - - - - - - - - - - - - - @ @ - @ - - - @ @ @ @ @ - - - - - - - - - - - - @ @ - - - - - - - - - - @ @ @ - - - @ - - - @ @ @ @ @ - - @ @ @ - - - - - @ @ @ - - - - - @ - - - - - - - - - - - - - - -|
|- @ @ @ @ @ - - - - - - - - @ @ @ @ @ @ @ - @ @ @ @ - - @ @ @ - - - - - - - - @ @ - - - - @ @ @ @ @ - - - - - - @ @ - @ @ @ @ - - @ @ - - - - - - - - - - - - - @ @ @ - @ - - - - - - - - - @ @ - - - -|
|- @ @ @ - - - - - - - - - - - @ @ - @ @ @ @ @ - - - - - - - @ @ - @ - - - - @ @ @ @ - @ @ @ - - @ @ - - - - - - @ @ @ @ - - @ @ @ @ @ - - - - - - - @ - - - - - - @ @ - - - - - - - - - - @ @ @ @ - - -|
|- @ @ @ @ @ @ @ @ - - - - - @ @ @ @ @ - @ @ - - - @ @ @ - @ @ @ - @ - - - - - - - - - - - @ - @ @ - - - - - - - - @ @ @ - - @ @ @ - @ @ - - - - - - @ - - @ @ @ @ @ @ @ @ - - - - - - - @ @ - @ @ @ - -|
|- - @ @ @ @ - - @ @ - @ - - @ - - @ @ - - - - - - - - @ @ @ @ - - @ - - - - - - - - - - - - - @ @ - - - - - - - @ @ @ - - - - - - - @ @ @ - - - - - @ - - - - - - - - - - - - - - - - - @ @ @ @ - - - -|
|- - @ @ @ @ @ @ @ @ @ @ - @ @ - - - @ @ @ @ @ @ @ - - - @ - - - - - - - - - - @ @ @ @ @ - - - - - - - - - - @ - @ @ - - @ @ @ @ - @ @ @ @ @ - - - - @ @ @ - - - - - - - - - - - - - @ - @ @ - @ @ @ - -|
|- - @ @ @ - - - - - @ @ - @ - - - - - - @ - - - - - - - @ @ - - - - - - - - - - - - @ @ - - - - @ @ @ @ @ - @ - - @ @ @ @ @ @ @ @ @ - - - @ - - - @ @ @ - - - - - @ @ - - - - - - - @ - @ @ - - @ @ - -|
|- @ @ - @ @ @ - - - @ - - @ - @ - @ - - @ @ @ - @ @ @ @ @ @ @ @ @ - @ @ @ - - - - - - - - - - - @ @ @ @ @ - @ - - - - @ - @ - - @ @ - - - @ - - - @ @ @ @ - - - - @ @ - - - - - - - @ @ @ @ - - - - - -|
|- @ - - @ @ @ - - - - - - - - @ @ @ - - - - - - - - - - @ @ @ - @ - @ @ @ @ @ - @ - - - - - - - - @ @ @ @ - @ @ - - - @ - - - - @ @ - - - @ @ @ - @ @ @ @ - @ - - @ - - @ @ - - @ @ @ @ - @ @ - @ @ @ @|
|- @ - - - - @ - - - - - - - - @ - @ - - - - - - - - - - - - - - @ - @ @ @ @ @ @ @ - - - - @ @ @ - @ - - - - @ @ - - - - - - - - @ @ @ - - - - - - @ @ - @ @ @ @ @ @ - @ @ @ - - @ @ - @ - @ @ - @ - - -|
|- @ @ @ @ - - - - - - - - - - - - @ - - - - @ @ @ @ @ @ - - - @ @ - @ @ - @ @ @ @ @ - - - - @ - - - - - - @ @ @ @ - @ @ - - - - @ @ - - - - - - - - - - @ @ @ @ @ @ @ @ @ - - - @ - - @ - @ @ - @ - @ @|
|- - - - - - - - - - - - - - - - - - - - - - - - - @ @ @ - - - @ @ - - - - @ @ - - @ @ - - - @ @ @ @ - - - @ @ - @ @ @ @ - - - - - @ - - - - - - - - - - @ @ - @ @ @ @ - @ @ @ @ @ @ @ @ - @ @ - @ - @ @|
|- - @ - - - - - - - - - - - - - - - - @ - - @ @ @ @ @ @ - - - - - - - - @ @ - - - @ @ - - - @ @ @ @ - @ @ @ @ - - - - @ @ @ - - - @ - - - - - - - - - - - - - @ @ @ - - - - - @ @ - - @ - - - - - - - -|
|- - @ - - - - - @ @ @ @ - - @ @ @ - - @ - - @ @ @ @ @ - - - - - @ @ - - @ @ - - - @ - - - - - - - - - @ @ - - - @ @ - - @ @ @ - - @ - - - - - - - - - - - - - - @ @ - - - - - @ - - - @ - - @ @ - - - -|
|@ @ @ - - - - - @ - - - - - - - - - - @ - - @ - @ - - - - - - - @ @ @ - - - - - - @ @ @ @ - - - @ - - - @ - - @ @ @ @ @ @ @ @ - - - - - @ @ - - - - @ @ - - - - - - - - - @ - - - - - - - @ @ @ - - - -|
|- @ - - - - - - @ - - - - - - - - - - @ @ @ @ - @ @ @ - @ @ - - - @ @ @ @ @ @ - - @ @ - @ - - - @ @ @ @ @ - - @ - - @ @ - - - - - - - - @ @ - - - - @ @ - - @ - - - - - - @ - - - @ @ @ @ @ @ - - - - -|
|- @ @ @ @ - - - @ - - - - - - - - - - - - @ @ @ @ @ @ - @ @ - - - @ @ @ @ @ @ - - - - - @ @ @ @ @ @ - @ @ @ - @ - - @ @ - - - - - @ - - - - - @ @ @ @ @ @ @ @ - - - - @ @ @ @ @ - - - - - - - - - - - @|
|- - - - @ @ - - @ - - - - - - - - @ - - - - - - - - @ - @ @ @ - - @ - - - - - - - @ @ @ @ - - - - - - @ - @ - - - @ @ @ - - - - - @ - - - - - - @ - - - - - @ - - - - - @ @ @ @ - - - - - - - - - - - @|
|- - - @ @ @ - - - - - - - - - - - @ - - - - @ - - @ @ - - - - - - @ @ @ @ - - - - - - - - - - @ @ @ @ @ @ @ - @ @ @ @ @ @ - - - - @ - - - - - - @ - - - @ @ @ - - - - - @ - @ @ - - - @ @ @ @ - - - - -|
|- - - @ @ - - @ - - - - - @ @ @ - @ - - - - @ - - @ - - - - - - - - @ @ @ - - - - @ @ @ - - - @ @ @ @ @ @ @ @ @ @ @ - - @ @ @ @ - - - @ - - - - @ @ @ - @ @ - - - @ @ @ @ @ @ @ @ @ - - - - @ @ @ @ - -|
|- - - - - - - @ - - - - - @ @ - - @ @ @ - - @ - - @ @ - - - - - - @ @ - @ - - - - @ @ @ - @ @ @ @ - @ @ @ @ - @ @ @ - - @ - - - - @ - @ - - - - - - - - - - - @ - - - - @ @ - - @ @ - - @ @ @ - - - - -|
|- - - - - - - @ - - - - @ @ @ - - - - - - - - - - - @ @ @ - @ @ @ @ @ @ @ - - - - @ @ @ @ @ @ @ @ - @ - - - - - - @ - - @ - - - - @ @ @ @ @ @ - - - @ @ @ - - @ - - - @ @ @ - - - - - - @ @ @ @ @ @ - -|
|- - - - - - @ @ @ - - - @ - @ @ @ - - - - @ @ @ - - - @ @ @ @ - - - - @ @ - - - - - - - - - - - @ @ @ @ @ @ - - - - - - @ - - @ @ @ @ - - - - - - - @ @ @ @ @ @ - - - - @ @ - - - - - @ @ - @ - @ @ - -|
|- - @ @ @ - - - - - - - @ - - - - - - - - - - - - - - @ @ @ - - - - - - - - - - - - - - - - - - @ @ @ - - - - @ @ - - - @ - @ @ @ - @ @ @ @ @ @ @ - - - - @ @ @ - - - - @ @ - - - - - @ @ - @ - @ @ @ @|
|- - - - - - @ @ @ @ - - @ - - @ @ - - - - - - - - - - @ - - - - - - - - - - - - - - @ @ - - - - @ - @ - - - - @ @ @ @ - - - @ - @ @ @ - - - - - - - - - - @ - - - - - - - @ @ @ @ @ @ @ - - @ - - - - -|
|- @ - - - - @ @ - @ - - @ - - @ @ - @ - - @ @ - - - - @ @ @ @ - - - - - - - - - - - @ @ - - - - @ - - - - - - - - @ @ - - - @ - - - - - - - - - - - - @ - - - - @ - - - - - - @ @ @ @ @ @ - @ - @ @ @ -|
|- @ - - - - @ @ @ @ - @ @ - - - - - @ - - @ @ - - - - @ - - @ @ - @ @ - @ - - - - - - - - @ @ - @ @ @ - - - - - @ @ @ - - - - - - @ @ @ @ - @ @ @ - - @ - - - - @ - @ @ - - - @ @ - - - - - - - @ @ @ -|
|- @ - - - - - - @ @ @ @ - - - @ - @ @ - - @ - - - @ @ @ @ - @ @ @ @ @ - @ - - - - - - - - @ @ - - @ @ - - @ @ - @ - - - - - - - - @ - - @ @ @ - - - - @ - - - - @ @ @ @ - - - - - - @ @ @ @ @ - @ @ - -|
|- - - - - - - - - - - @ - - - @ - @ @ - - @ - @ @ @ - - @ - - @ @ - @ @ @ - @ @ @ @ - @ @ @ @ @ @ @ - - - @ @ - @ - @ @ @ - - - - @ - - @ @ - - - - - - - - @ @ @ @ - - - - - - - - @ @ @ - - - - @ - -|
|- - - - @ @ @ @ - - - @ @ @ - @ - - @ @ - @ @ @ - - - - @ - - @ - - - - - - - - - @ @ @ - - - @ @ @ - - - - - - - - - - - - - - - - - - - - - - @ @ @ - - - - @ - @ - - - - - - @ - - - @ @ @ - - @ - -|
|@ @ @ @ @ - - @ - - - - - @ @ @ - - - @ - - @ @ @ @ - - @ @ @ @ - - - - - - - @ @ @ @ @ @ - @ @ - - - - - - - - - - - @ - - - @ - - - - - - @ @ @ - - - - - - @ @ @ @ @ - - - - @ - - - - - - - @ @ @ -|
|@ @ @ @ @ @ @ @ @ - - - - - @ @ - - - @ - - @ - - - - - @ @ @ - - - - - @ @ - - - - @ @ @ - @ - - - - - - - - - - - - @ - - - @ - - - @ - - @ - - - - - - - - - - - - - - - - - @ - @ - - - - @ @ @ - -|
|- - - @ @ @ @ - - - - - - @ @ @ - - - - - - - - - - - - - - - - - - - @ @ @ - - - - - - @ @ @ - - - - - - - - - - - - @ - - @ @ @ @ @ @ - - @ - @ @ - - - @ @ - @ @ - - - - - - @ - @ - - - - - @ @ @ @|
|- - @ @ - - @ @ @ - - @ @ @ @ - - - - - - - - - - - - - @ @ @ @ - - - @ @ - - - - - - - - - - - - - - - - @ @ @ @ @ - @ @ @ @ - - - - @ - - @ - @ @ - - - @ @ @ @ @ @ @ - - - - @ @ @ - - - - - - - - -|
|- - @ - - - - @ @ - @ @ @ - - - @ @ @ - - - - - - - - - - - - @ - - - @ @ - - - - - - - @ @ @ - @ - - @ @ @ @ @ @ @ @ @ - - @ @ - - - - - - - - - @ @ @ - @ @ @ @ @ @ - - - @ - @ @ @ @ @ - @ @ @ @ - -|
|- - @ - - - - - - - - - - - - - - - - - @ - - - @ @ - - - - @ @ @ @ - - @ @ @ - - - - - - - - - @ - @ @ @ @ @ @ - @ @ - - - @ @ @ @ @ @ - @ - - - - - - - @ @ @ - - - - - - @ - - - @ @ @ @ @ - @ @ - -|
|- - - - - - - - - - - - - @ @ @ - - - @ @ @ @ @ @ @ @ - - - @ @ @ @ - - - - - - - - - - @ @ @ - @ - @ - @ @ - @ - @ @ @ - - - @ - - - - - @ - - - @ @ - - @ @ @ @ @ @ - - - @ - - - - @ - @ @ - @ @ - -|
|- - - - - - - - @ @ - - - @ @ @ @ - - @ @ @ @ @ - - - - - - - - - - - - - - @ - - - - - @ - - - @ - @ @ @ @ - - - - - @ - @ - - - - - - @ @ @ @ - @ @ @ - - @ @ @ - @ - - - - - - - - @ - @ @ - @ @ - @|
|- - - - - - - - @ @ - - - - - @ @ - - @ - @ @ @ @ @ @ @ @ - - @ @ @ @ - - - @ - - - - - @ - - - @ - - - @ @ - - @ @ - @ - @ - - - - - - @ @ @ @ - - - @ @ @ @ @ @ - @ - - - - - @ @ - - - - @ - - - - @|
|@ @ @ @ @ @ @ - @ - - @ @ @ - @ @ @ - - - - - @ @ - - - @ - - - @ @ @ - - - @ - - - - - @ - - - - - - - @ @ - - @ @ - @ - @ - - - - - - - - - @ - - - @ @ - @ @ - - @ @ @ @ @ - @ @ - - @ @ @ - - - @ @|
|@ @ @ @ @ @ @ - @ - - @ @ @ - - - - - - - - - - @ @ @ @ @ - @ - @ @ @ - - - - - - - - @ @ - @ - - - - - @ @ - - - @ @ @ @ @ - - @ @ @ - - - @ @ - - - @ @ - - - - - - - - - - - - - - - @ @ @ - @ @ @ @|
|@ @ - @ - - - - @ - @ @ @ @ @ @ - - - - - - @ @ @ @ - - @ - @ - - - - - - - - - - - @ @ @ - @ - @ @ @ - - @ - - - - - - - @ - - - @ @ @ - - @ - - - - - - - - @ @ - - - - @ - - - - - - - - - - @ @ @ @|
|@ @ @ @ - - - - - - @ - - @ - - - - @ - @ - - - - @ @ - - - @ - - - - - - - - - - - - - - - @ @ @ @ @ - - @ - - - - @ - - @ @ @ - @ @ @ - @ @ - - @ @ - @ @ @ @ @ - - - - @ - @ @ @ - - - - - @ @ @ - -|
|@ @ @ @ - - - - - - @ - - - - - - - @ - @ - @ @ @ @ @ @ - - - - - - - - - - - - @ @ - @ - - @ @ @ - @ - - @ - - - - @ - @ @ @ @ @ @ @ @ @ @ - - @ @ @ - - - @ @ @ - - - - @ - @ @ @ @ - @ @ @ @ @ @ @ -|
|@ - - - - - - - - - @ - - - - - - - @ - @ - - - - - - @ @ @ @ - - @ - - - - - - @ @ - @ - - - - @ - @ @ @ @ @ - @ @ @ @ @ @ @ - - @ - @ - @ @ @ @ - - - - - @ @ @ @ @ - - - - @ - - - - @ @ @ - - - @ -|
|@ - - - - - - - - - - - - - - @ @ - - - - - - @ @ @ - - @ @ @ - - @ - - @ @ @ - - @ @ @ @ - - - @ - - - - @ @ - - - @ - - @ @ - - @ - @ @ @ - - - - - - - - - - - @ @ @ - - - - - - - - - @ @ @ @ @ @ -|
|@ - - - @ @ - - - - - - - - - @ @ - @ @ - @ - @ @ @ - - - - - - - @ - - - - - - - - @ @ @ - - @ @ @ - - - @ - - - - @ @ @ @ - - - @ @ @ @ @ @ @ @ @ - @ @ @ - - - - - @ @ @ - - @ @ @ - @ @ @ @ @ @ @ @|
|@ @ @ - @ @ - - - - - - - - - - - - @ @ @ @ - - - @ - - - @ @ - - @ @ @ - - - - - - - - - - - - @ @ @ @ @ @ - - - @ @ @ - - - - @ @ @ @ - - - - - - - - @ - - - - - - - - - - - @ @ @ - - - @ @ - - @ @|
|@ @ @ - - - - - @ - - @ - - - @ @ - @ @ - @ - @ @ @ - - - @ @ @ - @ @ - - - - - @ @ @ @ @ @ @ @ @ @ - - - - - - @ @ - @ @ @ - - @ @ - - - - - - - - - - @ - - - @ @ @ - - - - - @ @ @ - - - @ @ - - - -|
|@ @ @ - - - - - @ - - @ @ @ @ @ @ - @ @ - - - - @ - - - - @ @ @ @ @ - - - - - - @ @ @ - - @ @ @ - - - - - - - - @ - - @ - - - - - @ @ @ - - @ @ @ - @ @ @ - @ @ @ @ - - - - - - - @ @ - - - @ @ - - - -|
|- - @ - - - - - @ - - @ @ @ @ @ - - @ @ - - - - @ @ @ - @ @ @ @ @ @ - - @ @ @ - - @ - - @ @ @ - - - - - - - - - @ @ @ @ @ - - - - @ @ @ - - - - - - - - @ @ @ @ @ @ @ @ - - - @ - @ @ @ @ @ @ - - @ @ @|
|- - @ - - - @ @ @ - - @ @ @ @ @ @ - @ - - - - @ @ @ @ - @ @ @ - - - - - - - - - - @ - @ @ @ - - - - - - - - - - - - @ - @ @ @ - - @ @ @ - @ - - - - - - @ - - - @ @ @ @ - - - @ - @ @ - @ @ @ - - @ - @|
|- - @ - - - - - @ - - - @ @ - - @ - @ - @ - - @ - - - - @ - @ - - - - - - - - - - @ - - - @ @ @ - - - - - - - - - - @ - @ @ @ - - - - - - @ - - - - - - @ - @ @ @ @ @ @ @ - - @ - - - - - - - - @ @ - @|
|- - @ @ @ - - - - - - - - - - - @ - @ @ @ - - @ - - - @ @ @ @ - - @ @ @ - - - - - @ - @ @ @ @ @ @ @ - - - - - - - - - - - @ - - - - - - - @ @ @ - @ @ @ @ @ @ @ - - - - - - - @ @ @ - - - @ @ @ @ @ @ @|
|- - @ - - - - - - - - - - - - - @ @ @ @ @ @ @ @ - @ @ @ @ @ - - - - @ - - @ @ - - - - - @ - @ - @ @ - - - - - - - - @ @ @ @ - - - - - @ @ @ @ @ - @ @ @ @ @ @ - - - - - - - @ @ @ - - - - - - - - - @ @|
|- - @ @ @ @ - - - - - @ @ - - - - - - @ @ @ @ - - @ @ @ - @ - - - - @ - - @ @ - - - @ @ @ - @ - - - - @ @ @ @ - - - - - - - - - @ - @ @ @ - @ @ @ @ - - @ - @ @ @ - @ @ - - - - - - - - - - - - - - - -|
|- @ @ - @ - - - - - - @ @ @ @ - - @ - - - - @ - - @ - @ @ @ - - - @ @ - - - - - - - @ @ @ @ @ - - - @ @ @ @ @ @ @ @ - @ @ @ - - @ - - @ @ @ @ @ @ - - - - - - @ @ @ @ @ - - - - - @ @ - - - - - - - - -|
|- @ @ - @ - - - - - - @ @ @ @ - @ @ - - - - - - - @ - - - - - - @ @ @ - - - - - @ - - - @ @ @ - - - @ @ @ @ @ @ @ @ - @ @ @ - @ @ - @ @ - - - - - - - @ @ @ - @ @ @ - @ - - - @ - @ @ - - - - - - - - @|
|- @ @ - @ @ - - @ - - - - @ @ - @ @ @ - - - - - - @ - - - - - - - - @ @ - - - - @ - @ - - - @ - - - - @ @ - - - @ @ - - - @ @ @ @ - @ @ - - - - - - - - @ @ - - - - - @ @ @ @ @ @ @ - - - @ @ @ @ - - @|
|- - - - @ @ @ @ @ - - - - - - - - - @ - @ @ @ - - - - - - - - @ - - @ @ - - - - @ - @ - - - - - - - - @ @ - - - - - - - - - - - - - - - - - - @ @ @ - @ @ @ @ - - - - @ - - @ @ - @ @ @ @ @ @ @ @ - - -|
|- - - - - @ @ @ @ - - - - - - - - - @ - - - - - @ - - - - - - @ - - - @ - @ @ - - - @ - - - - - - @ @ @ @ @ @ - - @ - - - - - - - @ @ @ - - - @ - - - @ - @ @ @ @ @ @ @ @ - @ @ - - - - - @ @ @ @ - - -|
|- @ @ @ - - - - - - - @ @ @ - @ - - @ @ - - - @ @ - - - - - @ @ @ - @ @ - @ @ - @ @ @ - - @ - - - - - - @ @ @ @ - @ - - - - - - @ @ @ @ - - - @ - - @ @ - @ @ @ - - @ - - - - @ - - @ @ @ @ @ - @ - - -|
|- @ @ @ - - - - - - - @ @ - - @ - - - @ - - @ @ @ @ - - - - - - - - @ @ @ @ @ - - @ @ - - @ - - @ @ - - @ @ @ @ - @ - - - - - - @ @ @ @ - - @ @ - - @ @ - - - @ @ @ @ - - - - - - @ @ @ @ - @ @ @ - - -|
|- - - @ @ - @ @ @ - @ @ @ @ - @ @ @ - @ - - @ @ @ @ @ @ - - - - - - @ @ @ - @ - - @ @ - - @ - @ @ @ @ - - - @ @ - - - - - - - - @ @ @ - - - @ @ @ @ @ @ @ @ @ @ - - - - - @ @ - - @ @ @ @ - @ @ @ - - -|
|@ @ @ @ @ - - - - - @ @ @ - - - @ @ - @ - - - - - - - @ - - @ @ @ @ @ @ @ - @ @ @ @ @ @ - - - @ @ - - - - - @ @ - - - - - - - - @ @ @ @ @ - - - - - - @ - - - - - - - - - @ @ @ @ @ - @ @ @ @ - @ - @ @|
|@ - @ @ - - - - - - - - @ - - @ @ - - @ - @ @ - @ @ @ @ - - @ @ @ - - - @ @ @ @ @ @ - - - - - - - - - - - - - - - - - - - @ @ @ @ - - - - - - - @ @ - - - - - - - - - - - - - @ @ @ - @ @ @ @ @ @ - @ @|
|@ - @ @ @ - - - - - - - @ @ - @ @ - - - - @ @ - - - - @ - - @ - @ @ @ @ @ @ @ @ @ @ @ - - - - - - - - - - - - - - - - - @ @ @ @ @ @ @ @ - - - - @ @ - @ @ @ - @ @ - @ @ @ @ @ @ - - - @ - - @ @ @ - - -|
|@ @ @ @ @ @ - - @ @ - - @ @ - @ - - @ - - - - - - @ @ @ @ - @ - - - - @ @ - @ @ - @ @ - - - - - - - - @ - - - - - - - - @ @ - - - - - @ - @ - - - @ - - @ @ - @ @ - @ @ - - @ - - - - @ - - @ @ - - - -|
|@ @ @ @ @ @ - - @ @ - - - - - - - - @ - - - - - @ @ - - @ @ @ - - - - @ @ @ @ - - - @ - - - - @ @ @ - @ @ @ @ - - - - @ @ @ - - - - - @ - @ - - - @ @ @ @ @ @ @ @ - - - - - @ - - @ - @ - - - - - - - @|
|- @ - - @ @ @ - @ @ - - - - - - - - @ - @ - - - @ @ - - @ @ @ - - - @ @ - - @ @ @ - @ - - - @ @ @ @ - @ @ @ @ - - - - - - @ - @ @ @ @ @ @ @ - - - - @ @ @ @ @ @ @ - - - - - - - - @ - - - - - - - @ @ @|
|@ @ - - - - @ - @ @ - - - - @ - - - - - @ - - @ @ @ - - - - - - @ @ @ @ - - - - - - @ @ @ @ @ @ - - - - - - - - @ @ @ - - @ @ @ @ - @ - @ @ @ @ @ @ @ @ - - - - - - - - @ @ - - - @ @ - - - - - - - - @|
|@ @ - - @ @ @ - - @ @ - - @ @ - - @ - - @ - @ @ - @ @ @ @ - - - @ @ - @ @ @ @ - - - @ @ - - - - - - @ - - - - - @ - @ - - @ @ - @ - @ @ @ - @ @ @ @ @ - - - - - - - - - @ @ - - - - @ - - @ @ - - - - -|
|@ - - - - @ @ @ @ @ @ @ - @ @ - - @ - - - - @ @ - @ - @ - - @ @ @ @ - - - - @ @ @ @ @ @ - @ @ @ @ @ @ - @ @ @ - @ - @ @ @ @ @ - @ @ @ @ @ - - @ @ @ @ - - - - - - - - - - - - @ @ @ @ - - @ @ - - @ - -|
|@ - - - - @ @ - - - - @ @ @ @ - - @ - - - - - - - @ - @ - - @ @ - - - - @ - - - - - - - - @ @ @ - @ @ - @ @ @ - @ - @ @ @ - - - @ @ @ @ - - @ @ @ - - - @ @ @ @ @ - @ @ @ - - - - - - - - - - - @ @ - -|
|@ - - - - @ @ - @ @ @ @ - - - - - @ - - - - - - - - - @ @ - @ @ - - - - @ - - - - - - - - - - - - @ @ - @ @ @ - - - @ @ @ @ @ - @ @ @ @ @ @ @ @ @ - - - @ @ - - @ - @ @ @ - - - - - @ @ - - - - @ @ - @|
|@ - - - - - - - @ @ @ @ - - - - @ @ @ @ - @ - - - - - - @ @ @ @ - - - - @ - @ - - @ @ @ @ - - - - - - - @ - - - - - - @ - - - - - - @ @ - - @ @ @ @ - - @ @ - - @ - @ @ @ - - @ @ - @ @ - @ @ @ @ @ @ @|
|- - - - - - @ @ @ - - @ - - - - @ @ - - - @ - - - - - - @ - - - - - - - @ - @ - - @ - - @ - @ - @ @ @ @ @ - - - - - - @ - - - - - - @ @ @ @ @ - - @ - - @ @ @ - @ - @ @ - - @ @ @ @ @ @ - @ @ @ @ @ - -|
|- - @ @ @ @ @ @ @ - - - - - - - @ @ @ @ @ @ - - - - - - @ - - - - - - - @ - @ - - @ - @ @ - @ - - - @ @ - - - - - - - @ - - - - - - - - @ @ @ - - @ - - - - @ @ @ @ @ @ - - @ @ @ @ - @ - @ - - @ @ - -|
|- - - - - - - @ @ @ - - - - - - @ @ - @ - - - @ @ @ - - @ - - - - - - - @ @ @ - - - - @ @ - @ - - - - @ @ @ @ @ - @ @ @ - - - - - - - @ @ @ - - - @ @ - - - @ - - @ - - - - - - - @ @ @ - - - - @ @ @ @|
|@ - - - @ - - @ @ - - - - - - - @ @ - @ @ - @ @ - - - - - - - - - - - @ @ @ @ - - - - - - - - - @ @ @ @ @ @ @ @ - @ @ - - - - - - - - - @ - - - - @ @ - @ @ @ - - @ - - @ @ @ @ @ @ - @ - - @ @ @ @ - -|
|@ - - - @ - - @ @ @ - - - - - - @ @ - @ @ - @ @ - - - - @ @ @ - - - @ @ @ @ @ @ @ - - - - - - - - - - @ - - @ @ - @ @ - - - - @ @ @ - - @ - - - - @ @ @ @ @ - - - @ - - @ @ @ @ - - - - - - - - @ @ - -|
|@ @ @ - @ @ @ @ - @ @ - @ @ @ @ @ - - - @ - - - - - - - @ @ @ @ @ @ @ - - @ @ @ @ - - - @ @ - - - - - - - @ @ - - - - - - - - @ @ @ - - @ - - - - @ @ @ - - - - - @ - - @ @ @ @ - @ @ @ @ @ @ - - @ @ @|
|@ @ @ - - - - - - @ @ @ @ - - @ @ - - - - - - - - - - - @ - - - - @ @ - @ @ - - - - - - @ @ - - - - - - - @ - - - @ @ - - - - - - @ - - - - - - @ @ - - - - - - - @ @ @ @ @ - - - @ @ @ @ - @ @ @ @ @ @|
|@ - @ - @ @ @ - - @ - @ - - - - - - - - - - @ @ - @ @ @ @ - - - - @ @ - @ - - - - - @ - - - - - - - - - - @ @ @ @ @ @ - - - - - - - - - @ - @ - @ @ @ - - @ @ - @ @ @ @ - - - - - - - @ @ - @ @ @ - - @|
|@ @ @ - @ @ @ @ @ @ - @ - - - - - - - @ @ @ @ @ - @ @ @ @ @ - - - - - - @ - - - @ @ @ - - - - - - - - - - - @ @ @ - - - - - - - @ - @ @ @ - @ - @ @ @ - - @ @ @ @ @ - @ @ - - @ @ @ @ @ - - - - - - - @|
|- - - - @ @ @ @ @ - - @ @ - - - - @ @ @ @ - - - - - - - @ @ - - - - - - @ - - - - - @ @ - - @ - - - - - - - @ @ @ - - - - - - - @ @ @ @ @ - @ - - @ @ @ - @ @ @ @ - - @ @ @ @ @ - - - @ @ - - @ - - @ @|
|- - - - - - @ @ - - - - @ - @ - - - - - @ @ @ @ @ - - - @ @ - - - @ - - @ - - - - - @ @ - - @ - - - - - - - - - @ @ - - - - - - @ @ @ - - - - - - - - - - - - - @ @ @ @ - - - - - - - - @ @ @ @ - - @ @|
|- - - - @ @ @ @ - - - - @ @ @ - - - - - @ @ - @ @ - - - - - - - - @ - @ @ - - - @ @ @ - - - @ @ @ @ - - - - @ @ @ @ - - - - - @ @ @ @ - - - - - - - - - - - - - - @ @ - - - @ - - @ @ - - - - @ @ @ @ @|
|- @ @ - @ @ - - - - - - @ @ @ - - - @ - - - - - - - - - @ @ - - @ @ - @ @ - - - @ @ @ @ @ - - @ @ - - - - - @ @ - - - - @ @ - @ @ - - - - - - - - - - - @ @ @ - - - - - - - @ - - @ @ @ @ @ @ @ - - - -|
|- @ @ @ @ @ - - - - - - - - - - - - @ - - - - - - - - @ @ @ - @ @ @ - - - - - - @ @ @ - @ @ - - - - - - - - @ @ - @ @ @ @ @ @ @ @ - - - - - - - - - - @ @ @ - - @ @ @ - - - @ - - @ @ @ @ @ @ @ - - - -|
|@ @ @ @ - - - - - - - - - @ - - - - @ - @ - - @ @ - @ @ - - - @ @ @ - @ @ - - @ @ - - - @ @ - - - - @ @ @ - - - - @ @ - - - - - - - - - - - - - - - - - - - - - - - - - @ @ @ - - - - @ @ @ - @ @ @ @ @|
|@ @ @ @ - - - - @ - - - - @ - - - - @ @ @ @ - @ @ - @ @ - - - @ @ @ @ @ @ @ - @ @ - - - @ @ - - - - - - - - - - @ @ @ @ @ - - - - - - - - @ @ @ - - - - - - - @ @ - - - @ @ - - - - @ @ @ - - @ @ @ - -|
|@ @ @ - - - - - @ - - - - @ - @ @ - - @ @ @ - - - - @ @ @ - - - @ - @ - - @ @ @ - - - @ @ @ - - - - - - - @ @ @ @ @ @ - @ @ - - - - - @ @ @ - - - - - @ @ @ - @ @ - - - @ @ @ - - - @ @ - - @ @ @ @ - -|
|- - @ - - - - - @ - - - - @ @ @ @ - - - - @ - - - - @ - - - - - @ - @ - - - - - - - - @ - - - @ @ @ @ - - - - - - - - - @ @ - - - - - - @ - - - - @ @ @ - - - - - - - - @ @ - - - - @ @ - - - - - @ - @|
