50 50
|@ @ @ @ @ @ @ - - - - - - - @ - - @ @ - - - - - - @ @ - @ @ @ @ @ - @ @ @ @ @ - - - - @ @ @ @ - - -|
|@ @ @ @ - - - - - - - - - @ @ - - @ @ - - - - - - @ @ @ @ @ - - @ - - - @ @ @ - - - - @ @ @ @ - - -|
|@ @ @ @ - - - - - @ - @ @ @ @ - - - - - - - - - - - @ - - @ - @ @ @ - - @ - - - - - - - @ - @ - - -|
|- - - @ - - - - - @ - @ @ @ @ @ - - - - - - @ @ @ @ @ @ @ @ - - - - - @ @ @ @ @ - - - - - - - - - -|
|- - - @ @ @ - - - @ - @ @ @ @ @ - - - - - - @ @ @ @ @ - @ - - - @ @ @ @ - @ @ - - - - @ @ @ @ - - -|
|- - - @ @ @ @ @ @ @ - @ - @ @ @ @ @ - - - - - - @ - - - @ - - @ @ - - @ - - @ @ @ - - @ @ @ @ - - -|
|- - - @ @ @ @ @ - - - @ @ @ @ @ @ @ @ - - - - - - - - - @ - @ @ @ @ @ @ - - @ @ @ - @ @ @ - @ - - -|
|- - - @ @ @ @ @ @ @ - @ @ @ @ @ @ @ @ - @ @ @ @ @ - - - - - @ @ - - - - - - - @ @ - @ @ @ - - - - -|
|- @ - @ - - @ @ @ - - @ @ @ @ @ @ - @ - - @ @ @ @ - - - - - @ @ @ - - - - - - - @ @ @ - - - @ - - @|
|- @ - @ - - @ @ @ @ - @ @ @ - @ @ - - - - @ @ @ - - - - - - - @ @ @ @ - - - - - - @ @ - - @ @ - - @|
|- @ - - - - @ @ @ @ @ @ - @ - @ - - - - - - - - - - @ @ - - - @ @ @ @ - - - - - - - - - - @ @ - - -|
|@ @ @ @ @ @ @ @ - @ @ @ @ @ - @ @ @ @ @ - - - - - - @ @ @ @ - @ @ @ - - - - - - @ @ @ @ @ @ @ - - -|
|- - - - - @ @ @ - - - @ @ - - @ @ - @ - - - - - - - - @ @ @ - - - - - @ @ @ - @ @ @ - @ - @ @ @ - -|
|- - - - - - @ @ @ @ - - @ - - - @ @ @ - - - - - - - - - @ @ @ @ - - - @ - - - @ - - - @ @ @ @ @ @ -|
|- - - @ @ - @ @ @ @ @ - @ @ - @ @ - @ - - - - - - - @ @ @ - - - - - - @ - - @ @ - - - - @ @ @ @ @ -|
|- - - @ @ - @ @ - - @ - - @ - @ @ @ @ - - - - - @ @ @ - - - @ - - @ @ @ - - @ - - - - - - @ - - @ -|
|@ @ @ @ @ @ @ - - @ @ - - @ - @ @ - @ @ @ - - - @ @ - - - - @ - @ @ @ @ @ @ @ - - - - - - @ @ @ @ -|
|@ - @ - @ @ @ - - @ @ - - @ - @ @ @ @ @ - - - - - - - - - - @ @ @ - - - - - - - @ @ - - @ @ @ @ - -|
|@ - @ - @ @ @ - - @ @ - @ @ @ @ @ @ @ - - - - - - - - - - - - - @ @ - - - - - - @ @ - - - - - - - -|
|@ @ @ - @ - - - - @ @ @ @ - @ @ @ @ - - - - - - - - - @ - - - - @ @ - - - - - - - - - - - @ @ @ - -|
|@ - - - @ - - - - - - - @ - @ @ @ - - - - - - - @ @ - @ - - - @ @ @ - - - - @ @ - - - - @ @ @ - - -|
|@ - - @ @ - @ @ - - - - - - - - @ @ @ - - - - - @ @ - @ - - - @ - - - - - - @ @ - - - - - - - - - -|
|@ @ @ @ @ @ @ @ - - - - - - - @ @ @ @ @ @ @ - - - - - @ - - - @ @ @ @ - - @ @ - - - - - - - - - - -|
|- - - @ - - @ - - @ @ - - - - - @ @ @ - - - - - - - - @ - - - @ @ @ @ - - @ @ @ @ - - - - @ @ @ - -|
|- - - @ - - @ - - @ @ - @ - - - - - - - - - - - - - @ @ - @ @ @ @ - @ @ - - - @ @ - - - - - - - - -|
|- - - - - - @ - - - @ - @ - - - - @ - - @ @ - - - - @ @ - - - @ @ - @ @ - - - @ @ - - - - - - - - -|
|- - - - - - @ - - - @ @ @ - - - @ @ - @ @ @ @ - @ @ @ @ - - @ @ - - @ @ - - @ @ @ - @ @ - @ @ @ - -|
|@ @ @ - - - @ - - - - @ @ - @ @ @ @ - @ @ @ @ - @ @ - @ @ @ @ @ - - - @ @ - - - - - @ @ - - - - - -|
|@ @ @ - - - @ - - - - - - - @ @ - - - - - @ @ - @ @ - - - - - - - - - - @ @ @ - - - - - - - - - - -|
|- - - - - - @ - - @ - - - - @ @ - - - - @ @ @ - @ @ - - @ @ - - - - - - - - - - - - @ @ @ - - - @ @|
|- @ - - - - @ @ - @ @ - - - @ @ - - - - @ @ - - @ - - - @ @ @ - - - - - - - - @ @ @ @ @ @ @ @ @ @ @|
|- @ @ @ @ - @ @ @ @ @ - - - - @ - - - - @ @ - - - - - @ @ @ @ - - - - - - - - @ @ @ @ @ - - - - - -|
|- @ - @ - - - - @ @ @ - - - - - - @ - @ @ - - - - - - @ @ @ @ - - @ - - - - @ @ @ @ - - - - @ @ - -|
|- - - @ @ @ - @ @ - @ @ @ @ @ - - @ - @ @ @ @ @ - - - @ @ - @ @ @ @ - - - - - @ - - - - - - @ @ - -|
|- - @ @ @ @ @ @ @ - @ - - - - - - @ - @ - @ @ @ @ @ - @ @ - - @ @ @ @ - @ @ @ @ - - - - - - - - - -|
|- - @ @ @ - - - @ - - - - - - - - @ - @ @ @ @ - - - - - @ @ @ @ - @ @ - @ @ @ @ - - @ @ - - - - - @|
|- - @ @ @ - - - @ - - @ @ @ - - @ @ - - - - - - - - @ - @ - - - - - - - @ @ @ @ @ - @ @ - - - - - @|
|- - - - - - - - @ - - - - @ @ - @ - - @ - - - @ @ @ @ - @ - - - - - - - - - - - - - - - - - - @ @ @|
|- - - - - - - - - - - - - @ @ @ @ - - @ @ @ @ @ @ @ @ - - - - @ @ @ @ @ @ - - - - - - @ - - - @ - -|
|- - - - - - - - - - - - - - @ @ @ @ @ @ - - @ @ @ - @ - @ - - - - - - - @ @ @ - - - - @ @ @ - @ - -|
|@ @ @ - - - @ - - - - - - - @ - @ @ @ @ - - - - - - - - @ @ @ @ @ @ @ @ @ @ @ - @ @ @ @ @ - - - - -|
|- - - - - - @ - - - - - - @ @ @ @ @ @ @ - - - - - @ @ - @ @ - - - - - @ - - - - - @ @ @ @ - - - - -|
|- - - - - @ @ @ - - - - @ @ @ @ - @ @ @ @ - - - - @ @ @ @ @ - @ - - - @ - - - - - @ @ - @ @ @ - - -|
|- - - @ @ @ @ @ @ - @ @ @ - - @ - - - @ @ - - - - - - @ - @ - @ - - - - - - - - - - - - - - - - @ @|
|- - - @ - - - @ @ - @ @ @ - - - - - - @ - - - - - @ @ @ - - - @ - @ - - - @ @ - - - - - - - - - @ @|
|- - - @ @ - - @ @ - - @ - - - - - - - @ - - - - - @ @ - - - - - - @ @ @ - @ @ - - - - - - - - - - -|
|- - - @ @ - - @ - - @ @ @ @ @ @ - - - @ - - - - @ @ - - - @ - - - @ @ @ - - - - - - - - - - - - @ @|
|- - - @ @ - - @ - - @ @ - - - @ @ @ - - - @ - - @ - - - - @ - - - - @ @ @ - - - - - - - - - - - - -|
|- - - @ @ - - - - - @ - - - - @ @ @ @ - - @ @ @ @ - - - - @ - - - - @ - @ @ @ @ - - - - - - - - - -|
|- - - - @ - - - @ @ @ - - - @ @ @ @ @ - - @ @ @ @ - - - - - - - - - - - @ @ - - - - - - - - - - @ @|
