100 100
|@ @ - - - - - - - - - - - - - - - - - - - - - - - - - - - @ @ - @ @ @ - - - - - - - - - - - - - - - - - - - - - - - - - - - - - - - - - - - - - - - - - - - - - - - - - - - - - - @ - - - - - - - - - -|
|@ @ - - - - - - - - - - - - - - - - - - - - - - - - - - - @ @ - - - @ - - - - - - - - - - @ - - - - - - - - - - - - - - - - - - - - - @ @ @ - - - - - - - - - - - - - - - - - - - @ - - - - - - - - - -|
|- @ @ @ - - - - - - - - - - @ - - - - - - - - - - - - - @ @ @ @ - - @ - @ @ @ - - - - @ @ @ @ @ @ - @ @ - - - - - - - - - - - - - - - - - - - - - - - - - - - - - - - - - - - - - @ - - - - - - - - - -|
|- - @ @ - - - - - - - - - - @ - - - @ @ @ - - - - - - - - - @ @ - @ @ - - - - - - - - - - @ - - - - @ @ - - - - - - - - - @ @ - - - - - - @ - - - - - - - - - - - - - - - - - - - - - - - - - - - - - -|
|- - - - - - - @ @ - - - - - @ @ - @ @ @ @ @ @ - - - - - - - - - - @ - - - - - - - - - - - - - - - - - - - - - - - - - - - @ @ - @ @ @ @ - @ - - - - - - - - - - - - - - - @ @ @ - - - - - - - - - - - -|
|- - @ @ @ @ @ @ @ @ @ - - - - @ @ @ - - - - @ - - - @ @ @ - - - - @ - - - - - - - - - - - - - - - - - - - - - - - - - - - - - - @ @ @ @ - @ @ - - - - - - - - - - - - - - - - - - - - - - - - - - - - -|
|- - @ @ - - @ - - - - - - - - - - - - - - - @ - - - - - - - - - @ @ - - - - - - - - - - - - - - - - - - @ @ - - - - - - - - - - - - - @ - - @ @ - @ @ - - - - - - - - - - - - - - - - - - - - - - @ - -|
|- - @ @ @ - @ - - - - - - - - - - - - - - - - - - - - - - @ - - @ - - - - - - - - - - - - @ @ @ - - - - @ @ - - - - - - - - - - - - - @ - @ @ @ - @ @ - @ @ - - - - - - - - - - - - - - - - @ @ @ @ @ @|
|- - - - - - @ - - - - - - - - - - - - - - - @ @ @ - - - - @ - @ @ - - - - - - - @ @ @ - - - - - - - @ @ @ - - - - - - - - - - - - - - - - @ @ - - @ @ - @ @ - - @ @ @ @ @ - - @ @ - @ - - - - - - @ - -|
|- - - - - - - - - - @ @ - - @ @ - - - - - - - - - - - - - @ - @ - - - - - - - - - - - - - - - - - - @ - - - - - - - - - - - - - - - - - - - - - - @ @ - - - - - @ @ - @ - - - @ @ - @ - @ @ @ - - - - -|
|@ @ - - - @ @ @ - @ @ @ - - @ @ - - - - - - - - - - - - - @ - @ - - - - - - - - - - - - - - - - - - @ - - - - - - - - @ @ @ - - - - - - - - - - - - - - - - - - - - - @ @ @ - - - - @ - - @ @ @ @ @ @ @|
|@ @ - - - - - - - @ @ - - - - @ @ - - - - - @ @ @ @ - - - @ - - - - - - @ @ - - - - - - - - - - - - @ - - - - - - - - - - - - - - - - @ - - - - - - - - - - - - - @ - - - @ @ - - - - - - @ - - - - - -|
|@ @ - - @ @ @ @ @ @ - - - - - @ @ - - - - - @ @ @ @ - - - - - - - - - - @ @ - - - - - - @ @ @ - - @ @ - - - - - - - - - - - - - - - - @ - - - - - - - - - - - - - @ - - - @ @ - - - - - - - - - - - - -|
|@ @ - - @ @ @ @ - - - - - - - - - - - @ @ - - - - - - - - - - - - - - - - @ - - - - - - @ @ @ - - @ - - - - - - @ @ @ - - - - - - - - @ - - - - - - - - - - - - - @ - - - - - - - - - - - - - - - - - -|
|- @ - - @ @ @ - - - - - - - - - - - - @ @ - - - - - - - - - - - - - - - - @ - - - - - - - - @ - - @ - - - - - - @ - - - - - - - - - - - - - - @ @ @ - - - - - - - - - - - - - - - - - - - @ @ @ - - - -|
|- @ - - - - - - - - - - - - - - - - - - - - - - @ @ @ @ - - - - - - - - - - - - - - - - @ @ @ - - - - - - @ @ - @ - - - - - - - - @ - - - - - - - - - - @ - - - - - - - - - - - - - - - - - - @ @ @ - -|
|- - - - - - - - - - - - - @ @ - - - - - - - - - @ - - - - - - - - - - - - - - - - - - - - - - - - - - - - @ @ - @ - - - - - - - - @ - - - - - - - - - - @ - - - - - - - - - - - - - - - - - - - - - - -|
|- @ @ @ @ @ @ - @ @ @ - - @ @ @ - - - - - - - - @ @ @ @ - - - - @ @ @ - - - - - - - - - - @ @ @ - - - - - - - - - - - - - - - - - @ - - - - - - - - - @ @ - - - - - - - - - - - - - - - - - - - - - - -|
|- - - - - - - - @ @ - - - @ @ @ - - - - @ @ - - @ - - - - - - - - @ @ @ - - - - - - @ @ @ @ @ @ - - - - - - - - - - - - - - - - - @ @ @ @ - - - @ @ - @ @ - - - - - - - - - - - - - - - - - - - - - - -|
|- @ @ - - - - - @ @ - - - @ - - - - - - @ @ - - @ - - - - - - - - - - - - - - - - - - - - @ - - - - - - - - - - - - - - - @ @ @ - - - - - - - - @ @ @ @ - - - - @ @ - - - - - - @ @ - - - @ @ - @ - - -|
|- @ @ - - - - - - - - - - - - - - - - - - - - - @ - - - - - - - - @ - - - - - - - - - - - - - - - - - - - - - - - - - - - - @ - - - - - - - - - - - @ @ @ - - - @ @ - - - - - - @ @ - @ - @ @ - @ - - -|
|- - - - - - - @ @ @ - - - - - - - - - - - - - - - - - - - - - @ @ @ - - - - - - - @ @ @ - - - - @ - - - - @ @ @ - - - - - - @ - - - - - - - - - - @ @ - - - - - - - - - - - - - - - - @ - - @ @ @ - - -|
|- - - - - - @ @ - - - - - - - - - - - - - - - - - - - - - - - - - @ @ @ @ - - @ @ @ - - - - - @ @ - - - - - - @ @ @ - - - - @ - - - - - - - - - - @ @ - - - - - - - - - - - @ @ @ - - @ @ @ @ @ - - @ -|
|- - - - - - @ @ - - - - - - - - - - - - - - - - - - - - - - - - - - - - - - - - @ - - - - - - @ @ - - - - - - - @ @ - - - - - - - - - - - - - - - @ @ - - - @ @ - - - - - - - - - - - - @ - - - - - @ -|
|@ @ @ @ - - - - - - - - - - - - - - - - - - - - @ @ @ @ - - - - @ @ - - @ @ - - @ - - - - - - @ @ @ @ - - - - - - - - - - - - - - - - - - - - - - @ @ - - - @ @ - - - - - - - - - - - - @ - - @ - - @ -|
|- - - @ - - - - - - - - - - - - - - - - - - - - @ @ @ @ - - - - @ @ - - @ @ - - @ @ @ - - - - @ - - - - - - - - - - - - - - - - - - @ - - - - - @ @ @ - - - - - - - - - - - - - - - - - - - - @ - - - -|
|- - - @ - - - - - - - - - - - - - - - - - - @ @ @ @ @ @ @ - - - - - - @ @ - - - - @ @ @ - - - @ - - - @ @ - - - - - - - - - - - - - @ - - - - - @ @ - - - - - - - @ @ - - - - - - - - - - - - @ - - - -|
|- - - - - - - - @ - - - - - - - - - - - - - - - - @ @ @ @ - - - - - - @ @ - - - - @ @ @ - - - - - @ - @ @ @ @ - - - - - - - - - - - @ - - - - - - - - - - - - @ @ @ @ - - - - - - - - - - - - - - - - -|
|- - - @ @ @ - - @ - - - - - - - - - - - - - - - - @ @ - - - - - - @ @ @ @ @ - - - @ - - - - - @ - @ - - - @ @ - - - - - @ @ - - - - - - - - - - - - - - - - - @ @ - - - @ @ - - - - @ @ - - - - - - - -|
|- @ @ @ @ @ - - @ - - - - - - - - - @ @ @ - - - - @ @ - - - - - - - - - - - - - - @ - - - - - @ - @ - - - @ - - @ @ - - @ @ - - - - - - - - - - - - - - - - - - - - - @ @ @ - - - - @ @ - - - - - - - -|
|- @ @ @ @ @ @ @ @ - - - @ @ @ @ - - - - - - - @ - - - - - - - - - - - - - - - - - - - - - - - @ @ @ @ @ - @ - - @ @ - - - - - - - - - - - - @ @ @ - - - - @ @ @ - - - @ - - - - - - - - - @ @ @ - - - -|
|- - - - - - - - - - - - - @ - @ - - - - - - - @ - - - - - - - - - - - - - - - @ - - @ @ - - - @ @ - - @ - @ - - - - - - - - - - - - - - - - - - - - - - - - - - - - - @ - - - - @ - - - - @ @ @ - - - -|
|- - @ @ - - - - - - - - - @ - @ - - - - - - - @ - - - - - - - - - - - - - - - @ - - @ @ - - - - @ - @ @ - - - - - - - - - - - - - - - @ @ - - - - @ - - - - - - - - - - - - - - @ - - - - @ @ @ - - - -|
|- - @ @ - - - - - - - - - @ - @ @ - - - - - - @ - - - - - - - - - - - - - - - @ - - - - - - - - @ @ @ - - - - - - - - @ @ - - - - - @ @ @ @ - - - @ - - - - - @ @ @ - @ @ @ - - @ - - - - - - @ @ - - -|
|- - @ - - - - - - - - - - - - - @ @ @ - - - - - - - - - - @ - - - - - - - - - - - - - - @ @ @ - - - - - - - - - - @ @ @ @ @ @ @ - - @ - - @ - - - @ - - - - - @ @ @ - - - - - - - - - - - - - @ @ - @ @|
|- - @ - - - - - - - - - - - - - @ @ @ - - - - @ @ @ - - - @ - - - - @ @ @ - - - - - - - - - - - - - - - - - @ @ @ @ @ - @ @ - - - - @ - - @ - - - - - - - - - - - - - - - - - @ @ @ - - - - - - - - @ @|
|- - - - - - - - - - - - - @ @ - - - - - - - - - - - - - - @ - - - - - - - - @ @ - - - - - - - - - - - - - - @ @ @ - - - - - - @ @ @ @ - - @ - - @ @ - @ - - - - - - - - - - - @ @ - - - - - - @ - - @ @|
|- - - - - - @ - - - - - - @ @ - - - - - @ @ @ @ @ @ - @ - - - - - - - - - - @ @ - - - - - - - - - - - - - - - - @ - - - - - - - - - - - - - - - @ @ - @ - - - - @ - - - - - - @ @ - @ @ @ - - @ - - @ @|
|- - @ @ - - @ - - - - - @ @ - - - - - - @ @ @ - @ @ - @ - - - - - - @ - - - - - - - - - - - - - - @ @ - - - - - @ @ - - - - - - - - - - - @ @ - - @ - @ - - - - @ - - - - - - @ @ - @ @ @ - - @ - - - -|
|- - @ @ - - @ - - - - - @ @ - - - - - - @ - - - - - - @ - - - - - @ @ - @ @ - - - - - - - - - - - @ @ - - - - - @ @ - - @ @ - - - - - - - @ @ @ @ @ - - - @ @ @ @ - - - @ @ - @ @ - - - @ - - - - - - -|
|- - - - - - @ - - - - - - - - - - - - - - - - - - - - - - - @ - - @ @ - @ @ - - - - - - @ - - - @ @ @ - - - - - - - - - @ @ - - - - - - - - - - - @ - - - @ @ - - - - - @ @ - - - - - - - - - - - - - -|
|- - - - - - - - @ - - - - - - - @ @ @ - - - - - @ @ - - - - @ @ @ @ - - @ @ - - - - - - @ @ @ - @ @ @ - - - - - - - - - - - - - - - - - - - - - - - - - - @ @ - - - - - - - - - - - - @ @ - - - - - - -|
|- - - - - - - - @ - - - - - - - - - - - - - - - @ @ - - - - @ - - - - - - - - - - - - - @ @ @ - - - @ - - - - - - - - - - - - - - - - - - - - - - - - - - - - - - - @ @ - - - - - - - @ @ - - - @ @ @ @|
|- - - - - - - - @ - - - - - - - @ @ - - - - - - - - - - - - - - - - - @ @ @ - - - - - - - - - - - - - - - - - - - @ @ - - - - - - - - - - - - - - - - - - - - - - - @ @ @ - - - - - - - - - - - - - - -|
|- - - - - - - - - - - - - - - - @ @ - - - - - - - - - - - - - @ @ @ - - - - - - - - - - - - - - - - - - - - - - - @ @ - - - - - - - - - - - - - - - - - - - - - - - - - @ - - - - - - - - - - - - - - -|
|- - - - - - - - - - - - - - - - - - - - - - - - - - - - - - - - - @ - - - - - - - @ @ - - - - - - - - - - - - - - - - - - - @ @ @ - - - - - @ @ - - - - - - - - - - - - @ - - - - - - - - - - - - - - -|
|- - - - - - - - - - - - - @ @ @ @ - - - @ @ - - - - - - - - - - @ @ - @ - - - - - @ @ - - - - - - - - - - - - - - - - - - - - - - - - - - - @ @ - - - - - - - - - - - - - - - - - - - - - - - - - - - -|
|- - - - - - - - - - - - - - @ - - - - - @ @ - - - - - - - - @ @ @ @ @ @ - - - @ @ @ - - - - - @ - - @ @ - - - - - - - - - @ - - - - - - - - - @ - @ @ @ - - - - @ - - - - - @ @ - - - - - - - - - - - -|
|- - - - - - - - - - - - - - @ - - - - - - - - @ @ - - - - - @ @ - @ @ @ - - - - - - - - - - - @ - - @ @ - - - @ - - - - - @ - - - - - - - - - @ @ @ @ @ - @ - - @ - - - - - @ @ - - - - - - - - - @ @ -|
|- @ @ - - - - - - - - - - - @ - - - - - - - - @ @ - - - - - - @ @ @ @ @ - - - - - - - - - - - @ - - - - - - - @ - - - - - @ - - - - - - - - - - - - @ @ - @ - - @ @ @ - - - - - - - - - - - @ @ @ @ @ -|
|- @ @ - - - - - - @ - - - - - - - - - - - - - - - - - - - - - @ @ - - - - - - - - - - @ @ - - - - - - - @ @ - @ - - @ @ - @ @ @ - @ - - - - - - @ @ @ - - @ - - - - - - - - - @ - - - - - - - - - - - -|
|- - @ @ @ - - - - @ - - - - - - - - - - - - - - - - - - - - - - - - - - - - - - - - - @ @ @ @ @ - - - - @ @ - - - - @ @ - - @ @ - @ - - - - - - - - - - - - - @ - - - - - - @ @ - - - - - - - - - - - -|
|- - - @ @ - - - - @ - - - - - - - - - - @ - - - - - - - - @ @ @ - - - - - - - - - @ @ @ @ - - - - @ - - - - - - - - - @ - - - @ @ @ - - - - - - @ - - @ @ - - @ - - - - - - @ @ - @ @ - - - - - - - - -|
|- - - @ @ - - - - @ - - - - - - - - - - @ - - - - - - - - - - - - - - - - - - - - - - - - - - - - @ - @ @ @ @ - - - - @ - - - - - - - - - - - - @ - - @ @ - - @ - - - - - - @ - - @ @ - - - - - - - - -|
|- - - @ - - - - - @ @ @ - - - - @ - - - @ - @ @ @ - - - - - - - - - - - - - - - - - - - - - - - - @ @ @ @ - - - - - - - - - - - - - - - - - - - @ - - - @ - - - - - - - - - - - - - - - @ @ @ - - - - -|
|- - - @ - - - - - @ @ @ - - - - @ - - - - - - - - - - - - @ @ - - @ @ @ - @ @ @ - - - - - - @ - - - @ @ @ - - - - - - - - - @ @ - - - @ - - - - - - - - @ - - - - - - - - - - - - - - - @ @ @ - - - - -|
|- - - @ - - - - - - - - - - - - @ - - - - - - - - - - - - @ @ - - @ @ - - @ @ @ @ @ - - - - @ - - - @ - - - - @ @ - - - - - @ @ - - - @ @ - - - - - - - @ - - - - - - - - - - - - - - - @ - - - - - - -|
|- - - - - - - - - @ - - - - - - - - - - - - - - - - - - - - - - - @ @ - @ @ @ - - - - - - - @ @ @ - @ @ @ @ @ @ @ - - - - - - @ @ - - @ @ - - - - - - @ @ - - - - - - - - - - - - - - - - - - - - - - -|
|- - - - - - - - - @ - - - - - - - - - - - - - - - - - - - - - - - - - - - - @ @ @ - - - - - @ - - - - - - - @ - - - - - - - - @ @ @ - - @ - - - - - - @ @ @ @ - - - - - @ @ @ @ - - - - - - - - - - - -|
|- - - - - - - - @ @ @ - - - - - - - - - @ @ @ - - - - - - - - - - - - - - - @ - - - - - - - @ @ @ - - - - - @ @ @ - - - - - - - - @ @ - - - - - - - - @ - - - - - - - - @ @ @ @ - - - - - @ - - - - - -|
|- - - - - - - - - - - - - @ - - - - - - - - - - - - - - - - - - - - - - - - @ - - - - - - - @ @ @ - - - - - - @ @ - - - - - - - - @ @ - - @ @ - - - - @ - - - - - - - - - - - - - - - - - @ - - - - - -|
|- - - - - - - - - - - - - @ - - - - - - - - - - - - - - - - - - - - - - - - @ - - - - - - - - - @ - - - - @ @ @ @ - - - - - - - - - - - - @ @ - - - - @ - - - - @ @ @ - - - - - @ - - - - @ @ @ @ @ - -|
|- - - - - - - @ @ - - - - @ - - - - - - - @ @ @ - - - - - - - - - - - - @ @ @ @ @ @ - - - - - - @ - - @ @ @ - - - - - - - - - - - - - - - - - - - - - - - - - - - - - - - @ @ - @ - - - - - - - @ @ @ -|
|- - - - - - - @ @ - - - - @ @ @ @ - - @ - - - @ @ - - - - - - - - - - - - - - - - - - - - - - @ @ @ - @ @ @ - - @ @ @ - - - - - - - - - - - - - - - - @ @ @ @ @ - - - - - @ @ - @ - - - - - - - - - - -|
|- - - - - - - - - - - - - - - - - - - @ @ @ - @ @ - - - @ @ - - - - - - - - - - - - - - - - - - - - - @ - - - - - - - - - - - - - - - - - - - - - - - - - - @ @ - - - - - - @ - - - - - - - - @ @ @ @ -|
|- - - - - - - - - - - - - - - @ @ @ - @ - - - - - - - - @ @ - - - @ @ @ - - - - - @ @ @ @ - - - - - - - - - - - @ @ @ - - - - - - - - - - - - - - - - - - - - @ - - - - - - - - - - - - @ @ @ @ @ - - -|
|- - - - - - - - @ @ @ @ - - - - - - - - - @ @ - - - - - - @ @ @ - - - - - - - - - @ @ @ @ @ - - @ @ @ - - - - - - - - - - - - - - - - - - - - - - - - - - - - @ - - - - - - - - - - - - - - @ @ @ - - -|
|- - - - - - @ @ @ - - - - @ - - - @ @ @ - @ @ - - - - - - @ @ @ - - - - - - - - - @ - - @ @ - @ @ @ - - - - - - - - - @ - @ @ - - - - - - - - - - - - - - - - @ - - - - @ - - - - - @ @ @ - @ - @ @ @ -|
|- - - - - - - - - - - - - @ - - - - - - - - - - - - - - @ @ - - - - - - - - - - - @ - - - - - - - - - - @ - - - @ @ @ @ - @ @ - - - - - - - - - - - - - - - - - - - - - @ - - - - - - - @ @ @ - - - - -|
|- - - - - - - - - - - - - @ - - - - @ @ - @ @ - - - - - @ @ - - - - @ - - - - - @ @ - - - - @ - - - - - @ - - - - - - @ - @ - - - - - - - - - - - - - - - - - - - - - - @ - - - - - - - @ @ - - - - - -|
|- - @ @ - - - - - - - - - - - - - - @ @ - @ @ - - - - - - - - - - - @ - - - - - @ - - - - @ @ - - - - - @ - - - - - - - - @ - - - - - - - - - - - - - - - - - - @ @ @ - - - - - - - - - - - - - - - - -|
|- @ @ @ - - - - - - - - - - - - - - - - - - - - - - - - - - - - - - @ - - - - - @ - - - - @ @ @ @ - - - - - - - - - - - - - - - - - - - - - - - - @ @ - - - - - - - - - - - @ @ @ - - - - - - - - - - -|
|@ @ - - - - - - - - - - - - - - - - - - - - - - - - - - - @ @ - - - - - - - @ @ @ - - - - - - @ @ - - - - - - - - - - - @ @ @ - - - - - - - - - - @ @ - - - - - - - - - - - - - - - @ @ - - - @ @ @ - -|
|@ @ - - - @ @ - @ @ @ - - - - - @ @ @ - - @ @ @ - - - - - @ @ @ @ - - - - - - - @ @ @ @ - - - - - - @ @ - - - - - @ - - - - - - - - - - - - - - - - - - - - @ @ @ - - - - - - - - - @ @ - - - - - - - -|
|- @ @ - - @ @ - - - - - - - - - - - - - - - - - - - - - - @ @ - - - - - - @ @ @ @ - @ @ @ - - - - - @ @ - @ @ @ - @ - - - - - - - - - - - - - - - @ - - - - - - - - - - - - - - - - - - - - - - - - - -|
|- @ @ - - - - - - - - - - - - - - - - - - - - - - - - - - @ @ - - - - @ @ @ @ - - - - - - - - - - - - - - - - - - @ - - - - - - - - - - - - - - - @ - - - - - - @ - - - - - - - - - - - - - - - - - @ -|
|- - @ @ - - - - - - - - - - - - - - - - - - - - - - - - - - - - - - @ @ - - @ - - - - - - - @ @ @ - - - - - - - - @ @ - - - - - - - - @ @ - - - - @ - - - - @ @ @ - @ @ @ - - - - - - @ - - - - - - @ -|
|- - - @ - @ @ - - - - - - - - - - - - - - - - - @ @ - - - - - - - - @ @ - - - - - - - - - - - @ @ @ - - - - - - - - @ - - - - - - - - @ @ - - - - - - - - - @ @ @ - - - - - - - - - @ @ - - - - - - @ -|
|- - @ @ - @ @ @ - - - - - - - - - - - - - - - - @ @ @ @ - - - - - - - - - - - - - - - - - @ @ @ - - - - - - @ @ - - @ @ @ - - - - - - - - - - - - - - - - - - - @ - - - - - - - - - @ @ - @ @ - - - - -|
|- @ @ - - - - @ - @ - - - - - - - - - - @ - - - - - @ @ - - - - - - - - - - - - - - - - - @ @ @ - - - - - - @ @ - - @ @ @ @ - - - - @ - - - - @ @ @ @ - - - - - @ - - - - - - - - - - @ @ @ @ - - - - -|
|- @ @ - - - - @ - @ - - - @ @ @ - - - - @ - - @ @ @ @ @ - - - - - - - - - @ @ - - @ - - - - - - - - - @ - @ @ - - @ @ @ @ @ - - - - @ @ - - - - - @ @ - - - - - @ - @ - @ @ - - - - - - - - - - - - - -|
|@ @ @ @ - - @ @ @ @ - - @ @ - - - - - - @ - - - - - - @ - - - - - - - - - @ @ - - @ - - - - @ @ @ - - @ @ @ @ - - - @ - @ @ - - - - @ @ - - - - @ @ @ - - - - - - - @ - @ @ - - - - - - - - - - - - - -|
|- - - @ - - - - - - - - @ @ - - - - - - - - - - @ @ - @ - - - - - - - - - - - - - @ - - - - - - - - - @ - - - - - - @ - @ - - - - - - @ - - - - - - - - - - - - - - @ - - @ @ @ @ @ - - - - - - - - - -|
|- - - @ - - - - - @ - - - - - - - - @ @ - - - - @ @ @ @ - - - - - - - - - - - - - - - - - - - - - - - - - - - - @ - @ - - - - - - - - - - - - - - - - - - - - - @ @ @ - - - - - - - - - - - - - - @ - -|
|- - - - - - - - - @ - - - - - - - - @ @ - - - - - - - - - - - - - - - - - - @ - - - - - - - - - @ @ @ @ - - - - @ - - - - - - - - - - - - - - - - - @ - @ @ - - @ @ - - - - - @ @ - - - - @ @ - - @ - -|
|- @ @ @ - - - - - @ - - @ @ - - - @ @ - - - - - - - - - - - - - - - - - - - @ - - - - - - - - - @ @ @ @ - - - - @ - - - @ @ - - - - - - - - @ @ @ - @ - @ @ @ @ @ - - - - - - @ @ @ - - @ @ @ - - @ @ -|
|- - - - - - - - - - - - @ @ - @ @ @ @ - - - - - - - @ @ - - - - - - - - - - @ - - - - @ - - - - - - - - - - - - - - - - @ @ - - - - - - - - - @ - - @ - - - - - - - - - - - - - - @ - - - - - - - @ @ -|
|- - - - - - - - - - - - @ @ - - - - - - - - - - - - @ @ @ @ - - - - - - - - - - @ @ - @ - - - - - - - - - - - - - - - - - - - - - - - - - - - @ - - - - - - - - - - - - - - - - - @ - - - - - - - @ @ -|
|- - - - @ @ @ - - - - @ @ @ - - - - - - - - - - - - - - @ @ - - - - - - - - - - @ @ - @ @ - - - - - - - - - - - - - - - - - - - - - - - - - - @ @ @ - - - @ @ @ @ @ @ - - - - - - - - - @ - - - - @ @ -|
|- - - - - - - - - - - - - @ @ - - - - - - - - - - - - - - - - - - - - - @ @ @ @ @ - - - @ - - - - - - - - @ @ @ - - - - - - - - - @ @ - - @ @ @ @ @ - - - @ @ @ @ @ - - @ - - - - - - - @ - @ @ @ @ @ -|
|- - - - - - - - - - - - - @ @ @ - - - - - - - - - - @ @ - - - - - @ - - - - - @ @ - - - @ - - - - - - - - - - - - - - - - - - - - @ @ - - - - @ - - - - - - - - @ @ @ @ @ - - - - - - - @ - - - - - - -|
|- - - - - - @ - - - - - - - - @ - - - - - - - - - - @ @ - - - - - @ - - - - - - - - - - - - - - - - - - - - - - - - - - - @ @ @ - - @ - - - - @ - - - - - - - - @ @ @ @ @ - - - - - - - - - - - - - - -|
|- - - - - - @ - - - - - - - - @ @ @ @ @ @ - - - - - - - - - - @ - @ @ @ - - - - - - - - - - - - - @ - - - - - - - - @ @ - - @ @ @ @ @ - - - - - - - - - - - - @ @ @ @ @ - - - - - - - - - - - - - - - -|
|@ @ - - - - @ - - @ @ - - - - @ @ - @ @ @ @ @ - - - - - - - - @ - - @ @ - - - - - - - - - - - - - @ - - - - - - - - @ @ - @ @ - - - - - - - - - - - - - - - - - - - @ @ - - @ - - - - - - - - - - - - @|
|- - - - - - - - - @ @ - - - - - - - - - - @ @ - - - - - - - - @ - - - - - @ - @ @ - - - - - - - - @ - - - - - - - - @ - - @ @ - - - - - - - - - - - - - - - - - @ @ @ @ @ - @ - - - - - - - - - - @ @ @|
|- - - - - @ @ @ - - - - - - - - @ @ @ - - - - - - - - @ - - - - - - - - - @ - @ @ - - - - - - - - - - - - - - - @ @ @ - - - - - - - - - - - @ @ - - - - - - - - - - - - @ - @ - - - - - - @ - @ @ @ @ -|
|- - - - @ @ @ - - - - - - - - - - - - - - - - - - - - @ - - - - - - - - - @ - - - - - - - - @ @ @ - - - - - - - @ @ @ - - - - - @ - - - - - @ @ - - - - - - - - - - - @ @ - - - - @ @ @ - @ - @ - - - -|
|- - - - @ - @ - - - - - - - - - - - - - - - - - - - @ @ - - - - - @ @ @ - - - - - - - @ @ - - - - - - - - - - - - - - - - - - - @ - - - - - @ @ - - - - - - @ @ - @ @ @ - - - - - - - - - @ - @ - @ @ @|
|- - - @ @ - - - - - - - - - - - - - - - @ - - - - @ @ - - - - - - - - - - @ @ - - - - @ @ - - - - - - - - - - - - - - - - @ @ @ @ - - - - - @ - - - - - @ @ @ @ - @ @ - - - - - - - - - - - - @ - - - -|
|- - - @ @ @ @ - - - - - - - - - - - - - @ - - - - @ @ - - - - - - - - - - @ @ - - - - - - - - - - - - - @ @ @ - - - @ @ @ @ - - - - - - - - - - - - - - @ @ - - - - - - - - - - - - - - - - - - - - - -|
