20 6
|- - - - - - - - - - - - - - - - - - - -|
|- - - - - - - - - - - - - - - @ - - - -|
|- - - - - - - - - - - - - - - @ - - - -|
|- - - - - - - - - - - - - - - @ - - - -|
|- - - - - - - - - - @ - - - - - - - - -|
|- - - - - - - - - - @ - - - - - - - - -|
