20 20
|- - - - - - - - - - - - @ @ - - @ - - -|
|- @ - @ @ @ - - - - - - @ @ - @ @ - - -|
|- @ @ @ @ - - - - - @ @ @ @ - @ @ - - -|
|- @ @ @ @ - - - - - - - - @ - - - - - -|
|- - @ @ @ - @ @ - @ - - - - - @ @ @ @ -|
|@ @ @ - - - @ @ - @ @ @ @ @ @ @ @ @ @ @|
|- - @ @ @ @ @ @ - @ - @ @ @ @ @ @ - - -|
|- - - - - - - @ - - - - - - - @ @ @ - -|
|- - - - - - - @ - - - - - - - @ @ @ - -|
|- - - - - - - @ @ @ @ - - - - - @ @ - -|
|- - - - - - - - - - @ @ @ - @ @ @ @ - @|
|@ @ - - @ - - @ @ - @ @ @ @ @ - - @ - @|
|@ @ - - @ - - @ @ @ @ @ @ - - - - @ @ @|
|- - - - @ @ @ @ - - - @ @ - - - - @ @ @|
|- - @ @ @ - - @ @ - - @ @ @ - @ @ @ - @|
|- - @ @ - - - - @ @ @ @ @ @ - - - - - @|
|- - @ @ @ - - - @ @ - @ @ @ - - @ @ @ @|
|- - @ @ @ - @ - @ @ - @ - @ - - @ - - -|
|- - - - - - @ - @ @ - @ - @ - - @ - - -|
|@ @ - - - - @ - @ - - @ - @ - - - - - -|
