30 30
|- - - - - @ - - - - - - - - - @ - - - - - - - @ - - - - - -|
|- - - - - @ - - - - - @ @ @ - @ - - - - - - - @ - - - - - -|
|- - - - - - - @ @ @ - - - - - - - - - - - - - - - - - - - -|
|@ @ @ - - - - - - - - - - - - - - - - - - - - - - - - - - -|
|- - - - - - - - - - - - - @ - - - - - - - - - - - - - - - -|
|- - - - - - - - - - - - - @ - - - - - - - - - - - - - - - -|
|@ - - - - - - - - - - - - @ - - - - - - - - - - - - - - - -|
|@ - - - - - - - - - - - - - - - - - - - - - - - - - - - - -|
|@ - - - - - - - - - @ @ - - - - - - - - - - - - - - - - - -|
|- - - - - - - - - - @ @ - - - - - - - - @ @ @ - - - - - - -|
|- - - - - - - - - - - - - - - - - - - - - - - - - - - - - -|
|- - - - - - - - - - - - - - - @ - - - - - - @ @ - - - - - -|
|- - - - - - - - - - - - - - - @ - - - - - - @ @ - - - - - -|
|- - - - - - - - - - - - - - - @ - - - - - - - - - @ - - - -|
|- - - - - - - - - - - - @ - - - - - - - - - - - - @ - - - -|
|- - - - - - - - - - - - @ - - - - - - - - - - - - @ - - @ -|
|- - - - - - @ @ - - - - @ - - @ @ @ - - - - - - - - - - @ -|
|- - - - - - @ @ - - - - - - - - - - - - - - - - - - - - @ -|
|- - - - - - - - - - - - - - - - - - - - - - - - - - - - - -|
|- - - - - - - - - - - - - - - - @ - - - - - - - - - - - - -|
|- - - - - - - - - - - - - - - - @ - - - - - - - - - - - - -|
|- - - - - - - - - - - - - - - - @ - - - - - - - - - - - - -|
|- - - - - - - - - - - - - - - - - - - - - - - - - @ @ - - -|
|- - - - - - - - - - - - - - - - - - - - - - - - - @ @ - - -|
|- - - - - - - - - - - - - - - - - - - - - - - - - - - - - -|
|- - - - - - - - - - - - - - - - - - @ @ - - - - - - - - - -|
|- - - - - - - - - - - @ @ - - - - - @ @ - - - - - - - - - -|
|- - - - - - - - - - - @ @ - - - - - - - - - - - - - - - - -|
|- - - @ @ - - - - - - - - - - - - - @ - - - - - - - - - - -|
|- - - @ @ - - - - - - - - - - - - - @ - - - - - - - - - - -|
