50 50
|- @ - @ - - - - - - - - - - - - - - - - - - - - - - - - - - - - - - - - - - - - - - - - - - - - - -|
|- @ - @ - - - - - - - @ @ @ - - - - - - - - - - - - - - - - - - - - - - - - - - - - - - - - - - - -|
|- @ - - - - - - - - - - - @ @ @ @ - - - - - - - - - - - - - - - @ @ - - - - - - - - - - - - - - - -|
|- - - - - - - - - - - - - - - - - - - - - - - - - - - - - - - - @ @ - - - - - - - - - - - - - - - -|
|- - - - - - - - - - - - - - - - - - - - - - - - - - - - - - - - - - - - - - - - - - - - - - - - - -|
|- - - - - - - - - - - - - - - - - - - - - - - - - - - - - - - - - - - - - - - - - - - - - - - - - -|
|- - - - - - - - - - - - - - - - - - - - - - - - - - - - @ @ - - - - @ - - @ - - - - - - - - - - - -|
|- - - - - - - - - - - - - - - - - - - - - - - - - - - - @ @ - - - - @ - - @ - - - - - - - - - - - -|
|- - - - - - - - - - - - - - - - - - - - - - - - - - - - - - - - - - @ @ @ @ - - - - - - - - - - - -|
|- - - - - - - - - - - - - - - - - - - - - - - - - - - - - - - - - - - - - - - - - - - - - - - - - -|
|- - - - - - - - - - - @ - - - - - - - - - - - - @ @ - - - - - @ - - - - - - - - - - - - - - - - - -|
|- - - - - - - - - - - @ - - - - - - - - - - @ @ @ @ - - - - - @ - - - - - - - - - - - - - - - - - -|
|@ - - - - - - - - - - @ - - - - - - - - - @ @ @ - - - - - - - @ - - - - - - - - - - - - - - - - - -|
|@ - - - - - - - - - - - - - - - - - - - - @ - - - - - - - - - - - - - - - - - - - - - - - - - - - -|
|@ - - - - - - - - - - - - - - - - - - - - @ - - - - - - - - - - - - - - - - - - - - - - - - - - - -|
|- - - - - - - - - - - - - - - - - - - - - @ - - - - - - - - - - - - @ @ - - - - - - - - - - - - - -|
|- - - - - - - - - - - - - - - - - @ - - - - - - - - - - - - - - - - @ @ - - - @ - - - - - - - - - -|
|- - - - - - - - - - - - - - - - - @ - - - - - - - - - - - - - - - - - - - - - @ - - - - - - - - - -|
|- - - - - - - - - - @ - - - - - - @ - - - - - - - - - - - - - - - - - - - - - @ - - - - - - - - - -|
|- @ @ @ - - - - - - @ - - - - - - - - - - - - - - - - - - - - - - - - - - - - - - - - @ @ @ - - - -|
|- - - - - - - - - - @ - - - - - - - - - - - - - - - - - - - - - - - - - - - - - - - - - - - - - - -|
|- - - - - - - - - - - - - - - - - - - - - - - - - - - - - - - - - - - - - - - - - - - - - - - - - -|
|- - - - - - - - - - - - - - - - - - - - - - - - - - - - @ - - @ @ - - - - - - - - - - - - - - - - -|
|- - - - - - - - - - - - - - - - - - - - - - - - - - - - @ - - @ @ - - - - - - - - - - - - - - - - -|
|- - - - - - - - - - - - - - - - - - - - - - - - - - - - @ - @ @ @ - - - - - - - - - - - - - - - - -|
|- - - - - - - @ @ @ - - - - - - - - - - - - - @ @ - - - - - - - - - - - - - - - - - - - - - - - - -|
|- - - - - - - - - - - - - - - - - - - - - - - @ @ - - - - - - - - - - - - - - - @ @ - - - - - - - -|
|- - - - - - - - - - - - - - - - - - - - - - - - - - - - - - - - - - - - - - - - @ @ - - - - - - - -|
|- - - - - - - - - - - - - - - - - - - - - - - - - - - - - - - - - - - - - - - - - - - - - - - - - -|
|- - - - - - - - - - - - - - - - - - - - - - - - - - - - - - - - - - - - - - - - - - - - - - - - - -|
|- - - - - - - - - - - - - - - - - - - - - - - - - - - - - - - - - - - - - - - - - - - - - - - - - -|
|- - - - - - - - - - - - - - - - - - - - - - - - - - - - - - - - - - - - - - - - - - - - - @ @ - - -|
|- - - - - - - - - - - - - - - - - - - - - - - - - - - - - - - - - - - - - - - - @ @ - - - @ @ - - -|
|- - - - - - - - - - - - - - - - - - - - @ - - - - - - - - - - - - - - - - - - - @ @ - - - - - - - -|
|- - - - - - - - - - - - - - - @ @ @ @ - @ - - - - - - - @ - - - - - - - - - - - - - - - - - - - - -|
|- - - - - - - - - - - - - - - @ @ @ @ - @ - - - - - - - @ - - - - - - - - - - - - - - - - - - - - -|
|- - - - - - - - - @ - - - - - @ @ - - - - - - - - - - @ @ - - - - - - - - - - - - - - - - - - - - -|
|- - - - - - - - - @ - - - - @ @ - - - - - - - - - - @ @ - - - - - - - - - - - - - - - - - - - - @ @|
|- - - - - - - - - @ - - - - @ @ - - - - - - - - - - @ @ - - - - - - - - - - - - - - - - @ @ @ - @ @|
|- - - - - - - - - - - - - - - - - - - - - - - - - - - - - - - - - - - - - - - - - - - - - - - - - -|
|- - - - - - - - - - - - - - @ - - - - - - - - - - - - @ @ - - - - - - - - - - - - - - - - - - - - -|
|- - - - - - - - - - - - - - @ - - - - - - - - - - - - @ @ - - - - - - - - - - - - - - - - - - - - -|
|- - - - - - @ - - - - - - - @ - - - - - - - - - - - - - - - - - - - - - - - - - - - - - - - - - - @|
|- - - - - - @ - - - - - - - - - - - - - - - - - - - - - - - - - - - - - - - - - - - - - - @ @ - - @|
|- @ - - - - @ - - - - - @ @ @ - - - - - - - - - @ @ @ - - - - - - - - - - - - - - - - - - @ @ - - -|
|- @ - - - - - - - - - - - - - - - - - - - - - - - - - - - - - - - - - - - - - - - - - - - - - - - -|
|- @ - - - - - - - - - - - - - - - - - - - - - - @ @ - - - - - - - - - - - - - - - - - - - - - - - -|
|- - - - - - - - - - - - - - - - - - - - - - - - @ @ - - - - - - - - - - - - - - - - - - - - - - - -|
|- - - - - - - - - - - - - - - - - - - - @ - - - - - - - - - - - - - - - - - - - - - - - - - - - - -|
|- - - - - - - - - - - - - - - - - - - - @ - - - - - - - - - - - - - - - - - - - - - - - - - - - - -|
