20 20
|- - - - - - @ @ @ - - - - - - - - - - -|
|- - - - - - - @ - - - - - - - - - - - -|
|- - - - - @ @ @ - - - - - - - - - @ @ @|
|- - - - - @ @ @ - - - - - - - - - - - -|
|- - - - - - - - - - - - - - - - - - - -|
|- - - - - - - - - - - - - - - - - - - -|
|- - - - - - - - - - - - - - - - - - - -|
|- - - - - - - - @ @ - - - - - - - - - -|
|- - - - - - - - @ @ - - - - - - - - - -|
|- - - - - - - - - @ @ @ - - - - - - - -|
|- - - - - - - - - - - - - - - - - - - -|
|- - - - - - - - - - - - - - - - - - - -|
|- - - - - - - - - - - - - - - - - - @ @|
|- - - - - - - - - - - - - - - - - - @ @|
|- - - - - - - - - - - - - - - - - - - -|
|- - - - - - - - - - - @ - - - - - - - -|
|- - - - @ @ - - - - - @ - - - - - - - -|
|- - - - @ @ - - - - - @ - - - - - - - -|
|- - - - - - - - - - - - - - - - - - - -|
|- - - - - - - - - - - - - - - - - - - -|
