100 20
|- - - - - - - - - - - @ @ - - - - - - - - - - - - - - - - - - - - - - - - - - - - @ @ @ @ @ @ @ - - @ @ @ @ @ - - @ @ @ - - - - - - @ @ - - - - - - - - @ @ - - - - - - - - - - - - - - - - - @ @ @ @ -|
|- - - - - - - - - @ @ @ @ - - - - - - - @ - - - - - @ @ - - - @ @ - - - - - - - - - - - @ - - @ - - - - @ @ @ - - - @ - - - - - - - @ @ - - - - - - - @ @ @ @ @ @ @ - - - - - - - - - - - - - - - - - -|
|- - - - - - - - - @ @ @ @ - - @ @ @ - - @ - - - - - @ @ - - - @ @ @ @ - @ - - - - - - - @ - - @ - - - - - @ @ @ @ @ @ - @ @ @ @ - - @ @ - - - - - @ @ @ @ - - - - @ @ @ @ - - - - @ @ @ - - - - - - - -|
|- - - - - - @ @ - - - @ @ @ - - - @ @ @ @ - - - - - - - - - - - - - - - @ - - - - - @ @ @ - @ @ @ - - - - - - @ - - @ - @ - - @ - - @ @ @ - - - - @ @ - @ - @ @ - @ @ @ @ - - - - - - @ @ - - - - - - -|
|- - - - - - @ @ @ @ - - - @ - - - - - @ @ @ @ - - - - - - - - - - @ - - @ - - - - - @ @ @ - - - - - - @ @ - - @ - - - - @ - @ @ - - - - - - @ @ @ @ - - @ @ @ @ - - @ - - - @ @ @ - - @ @ - - @ @ - - -|
|- - - - @ - - - - @ - - - @ - - - - - @ - @ @ - - - @ @ @ @ - - - @ - - - - - - - - - - - - @ @ @ - - @ @ - - - - - @ @ @ @ @ - - - - - - - - - - - - - @ @ - - - - - - - - - - - - - @ @ - - @ @ - - -|
|- - - @ @ - - - - @ - - - - - - - - - @ - - @ - - - @ @ - - - @ @ @ - - @ @ @ @ @ - - - - - @ @ - - - - - - - - - @ @ @ - @ @ - - - - - - - - @ - - - - - - - - - - - @ @ @ @ @ @ @ @ @ - - - - @ @ - -|
|- - - @ @ - - @ @ @ @ @ @ @ @ @ @ @ @ @ - - - - - - - @ @ - - @ @ @ - @ @ @ - - @ @ @ @ - - @ @ - - @ @ - - - - - @ - - - @ @ @ - - - - - - - @ - - - - - @ - - - - - @ @ - - - - @ @ - - - - - @ @ - -|
|- - - @ - - - @ @ - - @ @ @ - @ - - - - - - - - - - - - @ @ @ @ @ @ @ @ - - - - @ @ @ @ @ @ @ @ @ @ @ @ @ @ @ @ @ @ @ - @ @ @ @ - @ @ @ @ - @ @ @ - - - - @ - @ @ @ @ @ - - - - - @ @ - - - - - - - - -|
|- - - @ @ - - @ - - - - - - - @ - - - @ @ - - - - - - @ @ - - @ @ - @ @ - - @ @ @ @ @ - - - - @ @ @ @ @ @ @ - - - - @ - @ - - @ - @ - - - - - @ - - - @ @ @ - - @ @ @ @ - - - @ @ @ - - - - - - - - - -|
|- - - - @ - - @ - - - - - - - @ - - - @ @ - - @ @ @ - @ @ - - @ - - - - - - - - @ @ - - - - - @ - @ @ - @ @ - - @ @ @ - @ @ @ @ - @ - - - - - @ - - - - @ @ - - @ - @ @ @ @ @ @ - - - - @ @ @ @ @ @ @ -|
|- @ - - @ - - @ - - - - - - - - - - - @ @ @ @ @ - - - - - - - - - - - - - - - - @ @ - - @ @ - @ - @ @ @ @ @ - - - - @ - @ - - @ @ @ @ - - - - @ - - - - @ @ - @ @ @ @ - @ @ @ @ - @ - @ @ @ @ @ @ - - -|
|- @ - - @ - @ @ - - - - - - - - - - - - - - - @ - @ @ - - - - @ @ - @ @ - - @ @ @ @ - @ @ @ @ @ - @ @ @ - - - - - - - - @ - - - - - @ @ @ @ - @ - - @ @ @ @ @ @ - - - - - - @ - - @ - - - @ @ - @ - - -|
|- @ - - @ @ @ @ @ @ @ - - - - @ @ @ @ - @ - - @ - @ @ @ - - - @ @ - @ @ - @ @ @ @ @ - @ @ @ @ - - - - @ - @ - - - - @ @ @ - - - - @ @ @ @ @ @ @ - - @ @ @ - @ @ - - - - - - @ - - @ - - - @ @ @ @ - - -|
|- - - @ @ @ @ @ @ @ @ @ @ @ - @ @ @ @ @ @ @ @ @ - - - @ - - - - - - - - - - - - @ @ - @ @ @ @ - @ @ @ @ - @ - - - @ @ @ - - - - - @ - - - @ @ - - - @ @ @ - - - - - - - - - - - @ @ - - - - - - @ @ - -|
|- @ @ @ @ @ - - @ - @ - - - - - - @ @ @ @ @ @ @ - @ @ @ - - - - - @ @ @ - - - - - - - @ @ @ @ - - - - - - @ - - - - - @ @ @ @ - - @ - - @ @ @ - - - @ @ - - - @ - - - @ @ @ - - @ @ @ - - - - - @ @ - -|
|- - - @ - @ - - @ - - - - - - - - - - @ - - - @ - @ @ @ - - - - @ @ - @ - - - - - - - - - - - - - - - @ @ @ @ - - - - @ @ @ @ - - - - - @ - - - - - - @ - - - @ - - - - - - - @ @ @ @ - - - @ - - - - @|
|- - - @ - @ @ - - - - - - - - - @ @ - - - - - @ @ @ - - - - - - @ - - @ - - - - - - - @ @ @ @ - - - @ @ @ - - - - - - - - - - - - - - - @ - - - - - - @ - - @ @ - - - @ @ @ @ @ - - @ @ @ - @ @ - @ @ @|
|- - - @ - @ @ @ @ - - @ @ - @ @ @ @ @ - - - - @ @ @ - - - - @ @ @ - - @ - @ @ - - @ @ @ @ @ @ - @ - @ @ - - - - - @ @ @ @ @ @ - - - - - @ - - - - - - - - - @ - - - - - - - - @ - - - @ @ - @ @ - @ @ @|
|- - - - - - @ @ @ @ - @ @ - @ @ - @ @ @ @ - - - @ - - - - - @ @ - - - - - @ @ - - @ @ @ - @ @ - @ - - - - - - - - @ @ @ - - - - - - - - - - - - - @ @ @ - - @ - - - - - - - - @ - - - - - - - @ - - - @|
