20 20
|- - - - @ @ @ - - - @ @ @ - - - - - - -|
|- - - @ @ @ @ - - - - - - - - - - - @ @|
|- - @ @ @ @ @ - - - - - - - - - - - @ @|
|- - - - - @ - - - - - - @ @ @ @ - - - -|
|- - - - - @ - - - - - - @ @ @ - - @ @ @|
|- - - - - @ - - - - - @ @ - - - @ @ @ -|
|@ - - - - - - - - - - @ @ @ @ - - - - -|
|@ - - - @ @ @ - - - - @ - @ @ - - - @ @|
|@ @ - - - - - - @ @ - @ - - - - - - @ @|
|@ @ @ @ @ @ - - @ @ - - - - - @ - - - -|
|- - - @ @ @ - - - - - - - - - @ @ @ - -|
|@ @ @ @ - @ @ - - - - - - - - @ @ - - -|
|- @ - @ - - @ - - - - @ @ - - - @ @ @ @|
|- @ - - - - @ - - - @ @ @ - - - - @ @ -|
|- - - - - - @ @ - @ @ @ @ @ - - - @ @ -|
|- - - @ - - @ @ - @ @ - - @ @ @ @ @ @ -|
|- - @ @ - - @ @ @ @ - - - - - @ @ @ @ @|
|- - @ @ - - @ @ @ - - @ @ @ - - - @ @ @|
|- - @ - - - - - @ - - @ @ @ @ @ @ @ - @|
|- - - - - - - - - - - @ - - - @ @ @ @ @|
