20 6
|- - - - - @ @ @ - - - - - - @ @ - - - -|
|- - - - - - - - - - - - - - @ @ - - - -|
|- - - - - - - - - - - - - - @ - - - - @|
|- - - - - - - - - - - - - - @ - - - @ @|
|- - @ @ @ - - - - - - @ @ @ @ - - - @ @|
|- - - - - - - - - - - - - - - - - - - -|
