20 6
|@ @ - - - - @ - - - - - - @ - - - - - -|
|- - - - - - @ - - - - - - @ - @ @ @ - -|
|- - - - - - - - - - - @ @ @ - - - @ @ @|
|- - - - - - - - - - - - - - - - - - - -|
|- - - @ @ @ - - - - - - - @ @ @ - - - -|
|- @ @ @ - - - - - - - - - @ @ @ - - - -|
