50 50
|@ @ @ - - - - - - - - - - - - - - - - - - - - - @ - @ - - - - - - - - - - - - - - - - - - - - - - -|
|- - - - - - - - - - @ @ @ - - - - - - - - - - - @ - @ - - - - - - - - - - - - - - - @ @ @ - - - - -|
|- - - @ - - - - - - - - - - - - - - - - - - - - @ - @ - - - - - - - - @ @ @ - - - - - - - - - - - -|
|- - - @ - - - - - - - - - - - - - - - - - - - - - - - - - - - - - - - - - - - - - - - - - - - - - -|
|- - @ @ - - - - - - - - - - - - - - - - - - - - - @ - - - - - - - - - - - - - - - - - - - - - - - -|
|@ @ @ - - - - - - - - - - - - - - - - - - @ @ @ - @ - - - - - - - - - - - - - - - - - - - - - - - @|
|- - - - - - - @ - - - - - - - - - - - - - - - - - @ - - - - - - - - - - - - - - - - - - - - - - - @|
|- - - - - - - @ - - - - - - - - - - - - - - - - - - - - - - - - - - - - - - - - - - - - - - - - - @|
|- - - - - - - @ - - @ @ @ - - - - - - - - - - - - - - - - - - - - - - - - - - - - - - - - - - - - -|
|- - - - - - - - - - - - - - - - - - - - - - - - - - - - - - - - - - - - - - - - - - @ @ - - - - - -|
|- - - - - - - - - - - - - - - - - - - - - - - - - - - - - - - - - - - - - - - - - - @ @ - - - - - -|
|- - - - - - - - - - - - - - - - - - - - - - - - - - - - - - - - - - - - @ @ - - - - - - - - - - - -|
|- - - - - - - - - - - - - @ @ @ - - - - - - - - - - - - - - - - - - - - @ @ - - - - - - - - - - - -|
|- - - - - - - - - - - - - - - - - - - - - - - - - - - - - - - - - - - - - - - - - @ @ @ @ @ - - - -|
|- - - - - - - - - - - - @ @ - - - - - - - - - - - - - - - - - - - - - - - - - - - - - - @ @ - - - -|
|- - - - - - - - - - - - @ @ @ - - - - - - - - - - - - - - - - - - - - - - - - - - - - - - - - - - -|
|- - - - - - - - - - - - - - - - - - - - - - - - - - - - - - - - - - - - - - - - - - - - - - - - - -|
|- - - - - - - - @ @ @ - - - - - - - - - - - - - - - - - - - - - - - - - - - - - - - - - - - - - - -|
|- - - - - - - - - - - - - - - - - - - - - - - - - - - - - - - - - - - - - - - - - - - - - - - - - -|
|- - - - - - - - - - - - - - - - - - - - - - - - - - - - - - - - - - - - - - - - - - - - - - - - - -|
|- - - - - - - - - - - - - - - - - - - - - - - - - - - - - - @ @ @ - - - - - - - - - - - - - - - - -|
|- - - - - - - - - - - - - - - - - - - - - - - - - - - - - - - - - - - - - - - - - - - - - - - - - -|
|@ @ @ - - - - - - - - - - - - - - - - - - - - - - - - - - - - - - - - - - - - - - - - - - - - - - -|
|- - - - - - - - - @ @ @ - - - - - - - - - - - @ @ @ - - - - - - - - - - - @ @ @ - - @ - - - - - - -|
|- - - - - - - - - - - - - - - - - - - - - - - - - - - - - - - - - - - - - - - - - - @ - - - - - - -|
|- - - - - - - - - - - - - - - - - - - - - @ - - - - - - - - - - - - - - - - - - - - @ @ @ - - - - -|
|- - - - - - - - - - - - - - - - - - - - - @ - - - - @ @ @ - - - - - - - - - - - - - - - - - - - - -|
|- - - - - @ - - - - - - - - - - - - - - - @ - - - @ @ @ - - - - - - - - - - - - - - - - - - - - - -|
|- - - - - @ - - - - - - - - - - - - @ - - - - - - - - - - @ @ - - - - - - - - - - - - - - - - - - -|
|- - - - @ @ - - - - - - - - - - - - @ - - - - - - - - - - @ @ - - - - - - - - - - - - - - - - - - -|
|- - - - @ @ - - - - - - - - - - - - @ - - - - - - - - - - - - - - - - - - - - - - @ @ - - - - - - -|
|- - - - - - - - - - - - - - - - - - - - - - - - - - - - - - - - - - - - - - - - - @ @ - - - - - - -|
|- - - - - - - - - - - - - - - - - - - - - - - - - - - - - - - - - - - - - - - - - - - - - - - - - -|
|- - - - - - - - - - - - - - - - - - - - - - - - - - - @ @ - - - - - - - - - - - - - - - - - - - - -|
|- - - - - - - - - - - - - - - - - - - - - - - - - - - @ @ - - - - - - - - - - - - - - - - - - - - -|
|- - - - - - - - - @ - - - - - - - - - - - - - - - - - - - - - - - - - - @ - - @ @ - - - - - - - - -|
|- - - - - - - - - @ - - - - - - - - - - @ - - - - - - - @ @ - - - - - @ @ - - @ @ @ - - - - - - - -|
|- - - - - - - - - @ - - - - - - - - - - @ - - - - - - - @ @ - - - - - @ @ - - - - @ - - - - - - - -|
|- - - - - - - - - - - - - - - - - - - - @ - - - - - - - - - - - - - - @ @ @ @ @ @ @ @ - - - - - - -|
|- - - - - - - - - - - - - - - - - - - - - - - - - - - - - - - - @ - - - - - - - - - - - - - - - @ -|
|- - - - @ - - - - - - - - - - - - - - - - - - - - - - - - - - - @ - - - - - - - - - - - - - - - @ -|
|- - - - @ - - - - - - - - - - - - - - - - @ @ @ - - - - - - - - @ - - - - - - - - - - - - - - - @ -|
|- - @ - @ @ @ - - - - - - - - - - - - - - - - - - - - - - - - - - - - - - - - - - - - - - - - - - -|
|- - @ - - @ @ - - - - - - - - - - - - - - - - - - - - - - - - - - - - - - - - - - - - - - @ - - - -|
|- @ @ @ - - - - - - @ - - - - - - - - - - - - - - - - - - - - - - - - - - - - - - - - - - @ - - - -|
|- - - - - - - - - - @ - - - - - - - - - - - - @ @ - - - - - - - - - - - - - - - - - - - - @ - - - -|
|- - - - - - - - - - @ - - - - - - - - - - - - @ @ - - @ @ - - - - - - - - - - - - - - - - - - - - -|
|- - - - - - - - - - - - - - - - - - - - - - - - - - - @ @ - - - - - - - - - - - - - - - - - - - - -|
|- - - - - - - - - - - - - - - - - @ @ - - - - - - - - - - - - - - - - - - - - - - - - - - - - - - -|
|- - - - - - - - - - - - - - - - - @ @ - @ @ - - - - - - - - - - - - - - - - - - - - - - - - - - - -|
