20 200
|- - - - - - - - - - - - - - - - - - - -|
|- - - @ @ - - - - - - - - - - - - - - -|
|- - - @ @ - - - - - - - - - - - - - - -|
|- - - - - - - - - - - - - - - - - - - -|
|- - - - - - - - - - - - - - - - - - - -|
|- - - - - - - - - - - - - @ - - - - - -|
|- - - - - - - - - - - - - @ - - - - - -|
|- - - - - - - - - - - - - @ - - - - - -|
|- - - - - - - - - - - - - - - - - - - -|
|- - - - - - - - - - - - - - - - - - - -|
|- - - - - - - - - - - - - - - - - - - -|
|- - - - - - - - - - - - - @ - - - - - -|
|- - @ - - - - - - - - - - @ - - - - - -|
|- - @ - - - - - - - - - - @ @ - - - - -|
|- - @ - - - - - - - - - - - @ @ @ - - -|
|- - - - - - - - - - - - - - - @ - - - -|
|- - - - - - - - - - - - - - - @ - - - -|
|- - - - - - - - - - - - - - - @ - - - -|
|- - - - - - - - - @ @ - - - - - - - - -|
|- - - - - - - - - @ @ - - - - - - - - -|
|- - - - - - - - - - - - - - - - - - - -|
|- - - - - - - - - - - - - - - - - - - -|
|- - - - - - - - - - - - - - - - - - - -|
|- - - - - - - - - - - - - - - - - - - -|
|- - - - - - - - - - - - - - - - - - - -|
|- - - - - - - - - - - - - - - - - - - -|
|- - - - - - - - - - - - - - - @ @ @ - -|
|- - - - - - - - - - - - - - - - - - - -|
|- - - - - - - - - - - - - - - - - - - -|
|- - - - - - - - - - - - - - - - - - - -|
|- - - - - - - - - - - - @ @ @ - - - - -|
|- - - - - - - - - - - - - - - - - - - -|
|- - - - - - - - - - - - - - - - - - - -|
|- - - - - - - - - - - - - - - - - - - -|
|- - - - - - - - - - - - - - - - - @ @ -|
|- - - - - - - @ - - - - - - - - - @ @ -|
|- - - - - - - @ - - - - - - - - - - - -|
|- - - - - - - @ - - - - - - - - - - - -|
|- - - - - - - - - - - - - - - - - - - -|
|- - @ @ @ - - - - - - - - - - - - - - -|
|- - - - - - - - - - - - - - - - - - - -|
|- - - - - - - - - - @ @ - - - - - - - -|
|- - - - - - - - - - @ @ - - - - - - - -|
|- - - - - - - - - - - - - - - - - - - -|
|- - - - - - - - - - - - - - - - - - - -|
|- - - - - - - - - - - - - - - - - - - -|
|- - - - - - - - - - - - - - @ @ @ - - -|
|- - - - - - - - - - - - - - - - - - - -|
|- - - - - @ @ - - - - - - - - - - - - -|
|- - - - - @ @ - - - - - - - - - - - - -|
|- - - - @ @ - - - - - - - - - - - - - -|
|- - - - @ - - - - - - - - - - - - - - -|
|- - - - @ - - - - - - - - - - - - - - -|
|- - - - - - - - - - - - - - - - @ @ - -|
|- - @ @ @ - - - - - - - - - @ @ @ @ - -|
|- - - - - - - - - - - - - - - - - - - -|
|- - - - - - - - - - - - - - - - - - - -|
|- - - - - - - - - - - - - - - - - - - -|
|- - - - - - - - - - - - - - - - - - - -|
|- @ - - - - - - - - - - - @ @ - - - - -|
|- @ - - - - - - - - - - - @ @ - - - - -|
|- @ - - @ @ - - - - - - - - - - - - - -|
|- - - @ @ @ - - - - - - - - - - - - - -|
|- - @ @ - - - - - - @ - - @ @ @ - - - -|
|- - @ @ - - - - - - @ - - @ - - - - - -|
|- - - - - - - - - - @ - - @ - - - - - -|
|- - - - - - - - - - - - - - - - - - - -|
|- - - - - - - - - - - - - - - - - - - -|
|- - - - - - - - - - @ - - - - - - - - -|
|- - - - - - - - - - @ - - - - - - - - -|
|- - - - - - - - - - @ - - - - - - - - -|
|- - - - - - - - - - - - - - - - - - - -|
|- - - @ @ @ - - - - - - - - - - - - - -|
|- - - - @ @ - - - - - - - - - - - - - -|
|- - - - @ @ - - - - - - - - - - - - - -|
|- - - @ @ @ @ @ - - - - - - - - - - - -|
|- - - @ @ - - - - @ @ - - - - - - - - -|
|- - - - - - - - - @ @ - - - @ @ - - - -|
|- - - - - - - - - - - - - - @ @ - - - -|
|- - - - - - - - - - - - - - - @ - - - -|
|- - - - - - - - - - - - - - - - - - - -|
|- - - - - - - - - - - - - - - - - - - -|
|- - - - - - - - - - - - - - - - @ - - -|
|- - - - - - - - - - - - - - - - @ - - -|
|- - - - - - - - - @ @ - - - - - @ - - -|
|- - - - - - - - - @ @ @ - - - - - - - -|
|- - - - - - - - - - - - - - - - - - - -|
|- - - - - - - - - - - - - - - - - - - @|
|- - - - - - - - - - - - - - - - - - - @|
|- - - - - - - - - - - - - - - - - @ - @|
|- - - - - - - - - - - - - - - - @ @ - -|
|- - - - - - - - - - - - - - - @ @ @ - -|
|- - - - - - - - - - - - - - - @ @ - - -|
|- - - - - - - - - - - - - @ @ @ - - - -|
|- - - - - - - - - - - - - - - - - - - -|
|- - - - - - - - - - - - - - - - - @ @ @|
|- - - - - - - - - - - - - - - - - - - -|
|- - - - - - - - - - - - - - - - - - - -|
|- - - - - - - - - - - - - - - - - - - -|
|- - - - - - - - - - - - - - - - - - - -|
|- - - - - - - - - - - - - - - - - - - -|
|- - - - - - - - - - - - - - - - - - - @|
|- - - - - - - - - - - - - - - - - - - @|
|- - - - - - - - - - - - - - - - - - - @|
|- - - - - - - - - - - - - - - - - - - -|
|- - - - - - - - - - - - - - - - - - - -|
|- - - - - - - - - - - - - - - - - - - -|
|- - - - - - - - - - - - - - - - - - - -|
|- - - - @ @ - - - - - - - - - - - - - -|
|- - - - @ @ - - - - - - - - - - - - - -|
|- - - - - - - - - - - @ @ - @ - - - - -|
|- - - - - - - - - - - @ @ - @ - - - - -|
|- - - - - - - - - - - - - - @ - - - - @|
|- - - - - - - - - - - - - - - - - - - @|
|- - - - - - - - - - - - - - - - - - - -|
|- - - - - - - - - - - - - - - - - - - -|
|- - - - - - - - - - - - - - - - - - - -|
|- - - - - - - - - - - - - - - - - - - -|
|- - - - - - - - - - - - - - - - - - - -|
|- - - - - - - - - - - @ @ @ - - - - - -|
|- - - - - - - - - - - - - - - - - - - -|
|- - - - - - - - - - - - - - - - - - - -|
|- - - - - - - - - - - - - - - - - - - -|
|- - - - - - - - - - - - - - - - - - - -|
|- - - - - - - - - - - - - - - - - - - -|
|- - - - - - - - - - - @ - - - - - - - -|
|- - - - - - - - - - - @ - - - - - - - -|
|- - - - - - - - - - - @ - - - - - - - -|
|- - - - - - - - - - - - - - - - - - - -|
|- - - - - - - - - - - - - - - - - - - -|
|- - - - - @ - - - - - - - - - - - - - -|
|- - - - - @ - @ - - - - - - - - - - - -|
|- - - - - @ - @ - - - - - - - - - - - -|
|- - - - - @ - @ - - - - - - - - - - - -|
|- - - - - - - - - - - - - - - - - - - -|
|- - - - - - - - - - - - - - - - - - - -|
|- - - - - - - - - - - - - - - - - - @ @|
|- - - - - - - - - - - - - - - - - - @ @|
|- - - - - - - - @ - - - - - - - - @ @ -|
|- - - - - - - - @ - - - - - - - - @ @ -|
|- - - - @ @ - - @ - - - - - - - - - - -|
|- - - - @ @ - - - - - - - - - - - - - -|
|- - - - - - - - - - - - - - - - - - - -|
|- - @ @ @ - - - - - - - - - - - - - - -|
|- - - - - - - - - - - - - - - - - - - -|
|- - - - - - - - - - - - - - - - - - @ -|
|- - - - - - - - - - - - - - - - - - @ -|
|- - - - - - - - - - - - - - @ @ @ - @ -|
|- - - - - - - - - - - - - - - - - - - -|
|- - - - - - - - - - - - - - - - - - - -|
|- - - - - - - - - - - - - - - - - - - -|
|- - - - - - - - - - - - - - - - - - - -|
|- - - - - - - - - - - - - - - - - - - -|
|- - - - - - - - - - - - - - - - - - - -|
|- - - - - - - - - - - - - - - - - - - -|
|- - - - - - - - - - - - - - - - - - - -|
|- - - - - - - - - - - - - - - - - - - -|
|- - - - - - - - - - @ - - - - - - - - -|
|- - - - - - - - - - @ - - - - - - - - -|
|- - - - - @ @ - - - @ - - - - - - - - -|
|- - - - - @ @ - - - - - - - - - - - - -|
|- - - - - - - - - - - - - - - - - - - -|
|- - - - - - - - - - - - - - - - - - - -|
|- - - - - - - @ - - - - - - - - - - - -|
|- - - - - - - @ - - - - - - - - - - - -|
|- - - - - - - @ - - - - - - - - - - - -|
|- - - - - - - - - - - - - - - - - - - -|
|- - - - - - - - @ @ @ - - - - - - @ @ -|
|- - - - - - - - - - - - - - - - - @ @ -|
|- - - - - - - - - - - - - - - - - - - -|
|- - - - - - - - - - - - - - - - - - - -|
|- - - - - - - - - @ @ @ - - - - - - - -|
|- - - - - - - - - - - - - - - - - - - -|
|- - - - - - - - - - - - - - - - - - - -|
|- - - - - - - - - - - - - - - - - - - -|
|- - - - - @ - - - - - - @ - - - - - - -|
|- - - - - @ - - - - - - @ - - - - - - -|
|- - - - - @ - - - - - - @ - - - - - - -|
|- - - - - - - - - - - - - - - @ @ @ - -|
|- - - - - - - - - - - - - - - - - - - -|
|- - - - - - - - - - - - - - - - - - - -|
|- - - - - - - - - - - - - - - - - - - -|
|- - - - - - - - - - - - - - - - - - - -|
|- - - - - - - - - - - - - - - - - - - -|
|- - - - - - - - - - - - - - - - - - - @|
|- - - - - - - - - - - - - - - - - - - @|
|- - - - - - - - - - - - - - - - - - - @|
|- - - - - - - - - - - - - - - - - - - -|
|- - - - - - - - - - - - - - - - - - - -|
|- - - - - - - - - - - - - - - - - - - -|
|- - @ @ @ - - - - - - - - - - - - - - -|
|- - - - - - - - - - - - - - - - - - - -|
|- - - - - - - - - - - - - - - - - - - -|
|- - - - - - @ @ @ - - - - - - - - - - -|
|- - - - - - - - - - - - - - - - - - - -|
|- - - - - - - - - - - - - - - - - - - -|
|- - - - - - - @ - - - - - - - - - - - -|
|- - - - - - - @ - - - - - - - - - - - -|
|- - - - - - - @ - - - - - - - - - - - -|
|- - - - - @ @ @ - - - - - - - - - - - -|
