10 10
|@ @ @ - - - - - - -|
|@ @ @ - - - - - - -|
|@ - - - - @ @ @ - @|
|@ - @ @ - - - - - @|
|@ - @ @ - - - - - @|
|@ - - - - - - - - -|
|- - - - - - - - - -|
|- - - - - - - - - -|
|- - - - - - - - - -|
|- - - - - - - - - -|
