10 10
|- - - - - - - - - -|
|@ @ @ - - - - - - -|
|- - - - @ @ - - - -|
|- - - - @ @ - - @ @|
|- - - - - - - - @ @|
|- - - - - - - - - -|
|- - - - - - - - - -|
|- @ - - - - - - @ -|
|@ @ - - - - - - @ -|
|@ @ - - - - - - @ -|
