20 6
|- - - - - - - - - - - - - - - - - - - -|
|- - - - - - - - - - @ - - - - - - - - @|
|@ @ @ - - - - - - - @ - - - - - - - - @|
|@ @ @ @ @ @ @ - - - @ - @ @ - - - - @ @|
|- - - @ @ @ - - - - - - @ @ - - - @ @ @|
|- - - - - @ - - - - - - - - - - - - - -|
