20 20
|- - - - - - - - @ - - - @ - - - - - - -|
|- - - - - - - - @ @ @ @ @ - - @ - - - -|
|- - - - @ @ @ @ @ - - - @ - - @ - - - -|
|- - - - - - @ @ - - - - - - - @ - - - -|
|- - - - - - @ @ - - @ @ @ - - @ - - - -|
|- - - - - - - - - - @ - - - - @ - - - -|
|@ @ - @ @ @ @ - - - @ - - - - @ - - - -|
|- - - @ - - - - - - @ - - - @ @ - - - -|
|- - - @ - @ - - - @ @ @ @ - @ @ - - - -|
|- - - - - @ - @ - - - - @ - - - - - - -|
|- - - - - @ - @ - - - - @ - - - - - - -|
|- - - - - - - @ - - - - @ - - - - - - -|
|- - - - - - - - - - - - - - - - - - - -|
|- - - @ - - - - - - - - - - - @ @ - - -|
|- - - @ - - - - - - - - - - - @ @ - - -|
|- - - @ - - - - - - - - - - - - - - - -|
|- - - - - - - - - - - - - - - - - - - -|
|- - - - - @ @ @ @ @ - - - - @ @ - - - -|
|- - - - - @ @ - - - - - - @ @ @ - - - -|
|- - - - - - - - - - - - - - - - - - - -|
