100 100
|- - - - - @ - @ - - @ @ - - - - - - - - - - @ @ @ - - - @ @ - - @ @ @ @ @ @ - - @ @ - - - - - - - - - - - - - - - - - - - @ @ - @ - - - - @ @ @ @ - - @ @ @ @ @ @ - - - - - - @ @ - - - - - - - - @ @ @|
|- - - - - @ - @ @ @ @ @ - - - - - - - - - - @ @ @ - - - @ @ - - @ @ @ @ @ @ - - @ @ - @ - - - - - @ @ - - - @ - - - - - - @ @ - @ @ - @ @ @ - @ @ - - @ @ @ @ @ @ - - - - - - @ @ - - - - - - - - @ - -|
|@ @ @ @ - @ @ @ @ @ @ - - - @ - - - - - - - - - @ @ @ @ @ @ @ - - @ - - - - - - @ @ - @ @ @ @ - @ @ @ - @ @ @ - - - - - - - @ @ @ @ - - - - - @ @ @ @ @ - - - - - - - @ - - - @ @ - @ @ @ @ - - - @ - -|
|@ - - - - @ @ - @ - - - - - @ - - - - - - - - - - @ @ @ @ - @ @ - - - - - - - - @ - - @ @ @ @ @ @ - - - - - @ - @ - - - - @ @ @ - @ - - - - - @ @ @ @ - - - - - @ - - @ - - - @ @ @ @ - - - - - - @ - -|
|@ - - @ @ @ - - - - @ @ @ - @ - - - - - - - - @ @ @ @ @ - - @ @ - @ @ @ - - - - @ - @ @ @ @ @ @ @ @ - - - - - - @ - - - @ @ - @ - - - - - @ @ @ - - @ - - @ @ @ @ - - @ - - @ @ @ @ @ @ - @ @ @ @ @ @ -|
|@ - - - - - - - - @ @ @ @ @ @ - - - @ @ - - - - - - @ @ - - @ - - - - - - - - @ @ - @ - - - @ @ @ @ - - - - - @ @ @ - - @ - - - - - - - - - - @ @ @ @ @ - @ @ - @ - @ @ @ @ @ - - @ @ - - - - - @ @ @ -|
|@ @ @ - - - - - @ @ @ @ @ @ - - @ @ @ @ - - - - - - @ @ - - - - @ @ - @ @ - - @ @ - @ - @ @ @ - - @ @ - - - - @ @ @ @ @ @ @ @ - - - - - @ @ @ @ @ - - - - - - - - - @ @ @ @ @ - @ @ @ - - @ @ @ @ @ @ @|
|@ @ - - - - - @ @ @ @ - @ @ @ - - - @ @ - @ @ - - - - - - - - - @ @ - @ @ @ @ @ @ @ @ - @ @ @ - - - @ - - - - - - - @ - @ @ @ - - @ @ - - - @ @ @ @ @ - - @ - - - - - - @ - - - - - @ @ @ @ @ - @ @ - -|
|- - - - - - @ @ - @ @ @ @ @ @ - - - @ @ @ @ @ - - - - - - - - @ @ @ @ @ - @ @ - - - - - @ @ - - - - @ - - - - - - - @ - @ - - - - @ @ - - - - - @ @ - - - @ - - - - - - @ - - @ @ - @ @ @ @ - - - - - -|
|- - - @ - @ @ @ - - - - - - @ - - - @ @ @ @ - - - - - - - - - @ - - @ - - @ @ - - - - @ @ - - - - - @ @ - - - - - - @ - @ - - @ @ @ @ @ - - - - @ @ - - - @ - - - - - @ @ @ @ @ @ - - @ - @ @ - - - - @|
|- @ @ @ - @ @ @ - @ @ - @ - - - - - @ - - - - - - @ @ - @ @ @ @ @ @ @ - - - @ - - - - @ @ @ @ - - - - @ - - - - - - - - - - @ @ @ - @ @ @ - - - - @ @ @ @ @ - - - - - - - - - - - - - @ - - @ - @ @ - @|
|- @ @ @ @ @ @ - - @ @ - @ - - - - @ @ - - - - - - @ @ @ @ - - @ @ @ - - - - @ - - - @ @ - @ @ - - - - @ - - - - - - - - @ @ @ - - - - - @ - - @ @ @ - - - - - - - - @ @ - - - - - @ @ @ - - @ - @ @ - @|
|- @ @ @ @ @ @ @ @ @ @ @ @ - - - - @ - - @ @ @ @ - @ @ @ - - @ @ @ - - - - - @ - - - @ - - @ @ @ @ @ - @ - @ @ - - - - @ @ @ @ - @ @ @ - @ - - @ @ - - - @ @ - - - - @ @ - - - - - @ @ @ - - - - - - - -|
|- - @ - @ - - @ @ - - @ - - - - - @ - - @ @ - - - - - - - - @ @ @ - - - - - - - - - @ - @ @ - @ - @ @ @ - @ @ - - - - - - @ @ - - @ - - @ - - - - - - - @ @ - - - - @ @ - - - - - - - - - - - - @ @ @ -|
|- - @ @ @ - - - @ - - @ @ @ @ - - - - - @ @ @ @ - - @ - - @ @ - @ @ - - - - - - - - @ - @ - - @ - @ @ @ - @ @ @ @ - - - - - @ - - @ - - - - - - - - - - - - - - - - @ @ - @ @ @ @ - - - - @ - - - - - -|
|- - - @ @ @ @ @ @ - - @ @ @ - - - - - - - - - - - - @ - - @ @ - @ @ @ - - @ @ - - - - - @ - - - - - - @ - - @ @ @ - - - - - @ - - - - - @ @ - - - - - - - - @ - - - - - - @ @ @ @ @ - - - @ - - - - - -|
|- - @ @ - - @ @ @ @ @ @ @ @ @ @ @ - - - - - - - - - @ @ @ @ @ - - - @ @ @ @ @ @ - - - @ @ @ - - - @ @ @ - - @ @ @ - - - - - - - - - - - @ @ - - - @ @ @ - - @ - - @ @ @ - - @ @ @ @ @ - @ @ - - - - @ @|
|@ - @ @ @ @ @ @ @ @ @ @ - - @ @ @ @ - - - @ - - - - - @ - @ @ - - - @ @ - - @ - - - - - - - - - - @ @ - - - @ @ @ - @ @ @ - - - - - - - - - - - @ @ @ @ - - @ - - - - @ - - - @ @ @ @ @ @ - - - - - @ @|
|@ @ @ - @ @ @ @ @ @ - - - - @ @ @ @ - - - @ - @ - - - @ @ @ @ @ @ @ @ @ @ - @ @ - - - - - - - - - - - - - - @ - - - @ @ @ @ @ @ - - @ - - - - - @ - @ @ @ @ @ - - - - @ @ - - @ @ - - - - - - @ @ - - -|
|@ @ - - @ @ @ @ - @ @ @ - - @ @ - @ - - - @ @ @ - @ - - @ - - - - - - @ @ - @ @ @ - - - - @ - - - - - - - - - - - - - - - - - - - - @ - - - - - @ - @ @ - - - - - - - - @ @ @ @ @ @ @ @ - - - @ @ - - -|
|- @ @ - @ @ @ @ @ @ @ @ - - @ @ - - - - - @ @ @ - @ @ @ @ - - - - @ - @ - - - @ @ - - - - @ - - - @ @ @ @ - @ - - - @ @ - @ - - - - @ - - - - - @ @ @ @ - - @ @ - - - - - - - - - - - - - - - @ @ @ - -|
|- - @ @ @ - - @ - - - - - - @ @ - - - - - - @ @ - @ - @ @ @ - - - @ - - - - - - - - - - - @ - - - @ @ @ @ - @ - - - @ @ - @ - - - - - - @ - - - - @ @ @ - - @ @ - - - - - - - - - - - - - - - - - - - -|
|- - - - @ @ @ @ - - - - - - @ @ - - - - - - @ @ @ @ - - - @ @ @ @ @ @ @ @ @ - @ @ - - - - - - - - @ @ - - - @ - - - - - - @ - - - @ - - @ - @ @ @ @ - - - @ @ - - @ @ @ - - - @ @ @ @ - - - - - @ @ @ -|
|- - - - - - - @ @ @ - - - - - - - - - - - - - - - @ - @ @ @ - - @ @ @ - - - - @ @ - - - - - - - - @ @ - - @ @ @ @ - - - - - - - - @ - - @ - @ @ @ @ - - - @ @ - @ @ @ @ - - - @ @ @ @ - - - - - - - @ @|
|@ @ @ - - - @ @ @ @ @ - - - - - - - - - - @ @ @ @ @ - - - @ - - - @ @ @ @ @ @ @ - - - @ - - - - - @ @ - - @ @ @ @ - - - @ @ - - - @ @ @ @ @ @ - @ @ - @ - - - - - - @ @ - - - @ @ @ @ - - - - - - - - @|
|- - @ @ @ - @ - - - @ @ @ @ @ - - - - - @ @ - @ @ - - - - - - - - - - @ @ - @ @ - - - @ @ @ - - - - @ @ - - @ @ @ @ @ @ @ @ @ - - - @ - - - - - @ @ - @ - - - - - - - - - - - @ - - - - - - - - - - - -|
|- - - - - - @ - - - - - - - - - - - - - @ @ - @ @ @ - - - @ @ - - - - @ @ @ @ @ - - - @ @ @ - - - - @ @ - - @ @ - @ @ @ @ @ @ - - - @ - @ @ @ - - @ - @ - - - - - - - - - - - @ - - - - - @ @ - - - - -|
|- - @ @ - - - - - - - - - - @ - - - - @ @ @ @ @ - @ @ - - @ @ - - @ @ @ @ - - @ - - - @ @ @ - - - - @ - - - @ @ - - - - @ - - - @ @ @ - - - - - @ @ - - - - @ @ @ - - - @ - - @ - @ @ - - @ @ - - - - -|
|- - @ @ - - - - - - - - - - @ - - @ @ @ @ - - @ @ @ @ - - - @ @ - - - - - - - @ - - - @ @ @ - - - @ @ @ @ @ @ @ @ @ @ - @ - - - @ @ @ - @ - - - @ @ - - - - - - - - - - @ - @ @ - @ @ - - @ @ @ - - - -|
|- - - @ @ - - - - - @ @ @ - @ @ - @ @ - - - - @ - @ @ - - - - @ - - @ @ @ - - @ - - - - - @ - - - - - - @ @ - @ - - - - @ - - - @ @ - - @ - - @ @ - - - - - - - - - @ @ @ - @ - - - - - - - - - - - @ @|
|@ @ @ @ @ - - - - - - - @ - - @ - - - - - - - - - - - - - - - @ - - @ @ @ - - - - - - @ @ @ - - - - - - - @ - @ - - @ - @ @ - - @ @ @ @ @ - - @ @ - - - - - - - - - - - - - @ @ @ @ - - - - - - - - - -|
|@ @ @ @ - - - - - - - - @ - - @ @ @ @ @ @ - - - - - - - - - - @ - - - - - - - - - - - @ @ - - - @ @ @ @ - - - @ - - @ - - @ - - - - @ @ - - - - - - - - @ @ @ @ @ @ @ @ @ - - - - - - - - - - - - - @ -|
|- - - - - - @ @ @ @ @ - - - - @ @ - @ @ @ @ @ - - - - @ @ - - - - - - - - - @ @ - - - @ @ @ @ - - - - @ - - - - - - @ - - @ - @ @ - @ @ - - - @ @ @ - - - - - - - - - - - - - - - @ @ @ - @ - - - - @ @|
|- - @ @ @ - @ @ @ @ @ - - - - - @ - @ - - @ @ - - - @ @ @ - - - @ @ - - - - @ @ @ @ - - - - - - - - @ @ - - - @ - - @ @ @ @ @ @ @ - @ - - - - - @ - - - - - @ - - - - - - - - - - @ @ @ @ @ @ @ - - @ -|
|@ @ @ @ @ - - - @ @ @ - - - - - - - - - - - @ @ - - @ @ @ @ @ - @ @ - @ @ @ @ @ @ @ - - @ @ @ @ @ @ @ @ @ - - @ - - - @ @ - @ @ @ - @ - @ - - - @ - - - - - @ @ @ - - - - - - - - @ @ @ @ @ @ @ - - - -|
|@ @ - @ @ @ @ - - - - - - - - - - - - - - - - @ - - @ - - @ @ - @ @ @ @ - - @ @ @ @ @ - @ @ - @ - - @ @ @ - - @ @ - - @ @ - - - @ @ @ - @ @ @ - @ @ - - - @ @ @ @ - - - - - - - @ @ - - - - @ @ - - @ @|
|- @ @ @ - @ @ - - - - - - - - - - @ @ - - @ @ @ - - @ - @ @ - - @ @ @ @ - - - - - - - - @ - - @ - - @ - @ @ - @ @ @ @ @ @ @ - - @ @ @ @ @ @ @ @ @ @ @ - - - - - - - - - - - - @ @ @ @ @ - - @ @ - @ @ -|
|@ @ - - - - @ - - - - - @ @ @ - - @ @ - - - - - - - @ @ @ @ - @ @ @ - - - - - - - @ - - @ @ - @ - - - - - @ - - @ - - @ @ @ - @ @ @ - - - @ @ @ - - - - - - - - - - - - - - - @ - - @ @ - - @ @ - @ - -|
|- - - - - - - - - - - @ @ - - - - @ @ - - - - - - - - @ @ @ - @ @ - - - - - @ @ @ @ - - @ @ - @ - - - @ - @ - - @ - - - - @ @ @ @ @ - @ @ @ - - - @ - - - - @ @ @ @ @ - - @ - @ @ @ @ - - - @ @ - @ - -|
|@ - @ - - - - - @ @ @ @ @ @ - @ @ @ @ @ - - - - - - - - - - - - - - - - - - - @ @ @ - - - - - @ - @ - @ - @ @ @ @ - @ - - - - - @ - - @ @ - - - - @ - - - - - - @ @ @ @ @ @ - @ - @ @ - - - - @ - @ - -|
|@ - @ @ @ @ @ @ @ - @ @ @ @ - - - - @ @ @ @ - - - @ @ @ - - - - - - - - - - - @ @ @ @ @ - - - @ - @ - @ - - @ @ @ @ @ - - - @ @ @ @ - @ @ - - - - @ @ - - - - - @ @ - - - @ - - - - @ - - - @ @ @ @ - @|
|@ @ @ @ @ @ - - - - @ @ - @ - @ @ - - @ @ @ @ @ @ @ @ @ - @ @ - - - - - @ @ @ @ @ - - - - - - @ @ @ - @ @ - - - - - @ - - @ @ @ - @ - - @ @ @ @ @ @ @ - - @ - - - @ @ @ @ @ - - - - @ @ @ @ @ - - @ - @|
|@ @ @ - - @ - @ @ - - - - - - @ @ @ @ @ @ @ - @ @ @ @ @ - @ @ @ - - - - - - - - @ - - - - - - - @ @ - @ @ @ @ - - - @ - - @ - @ - @ @ - - - - - @ @ - - - @ - - - - - - @ @ @ @ - - @ @ - - - - - @ - -|
|- - @ - - @ - @ @ - - - - - - @ @ @ @ - - @ - - @ @ @ - - - - - - - - - @ - - @ @ - - - - - - - @ @ @ @ - - - - - @ @ - @ @ - - - @ @ - - - - - - @ @ - - @ @ @ @ - - - - - - - - @ @ @ - - @ @ - @ - -|
|@ - @ - - @ @ @ @ @ @ - - - - @ @ - - - - @ - - - @ @ - - - - - - @ @ @ @ - - @ @ - - - - - - - @ @ @ @ - - - - - @ @ - @ @ @ @ - - @ @ @ @ @ @ @ @ @ - - - @ @ @ - - @ - - - - - @ @ - - - @ @ - @ - -|
|@ - @ - - @ @ - @ @ @ - - - - @ @ - - - - - - - - @ - - - - - - - @ @ @ @ @ @ @ @ - - - - - - - @ @ @ @ - - - - @ @ @ - @ @ @ @ - @ @ @ @ @ - - - - @ - - - @ @ @ - - @ - - - - @ @ - - - - - - - @ - -|
|@ - - - - @ - - @ - @ @ @ @ - - - - - - - - - @ - @ @ - @ @ - @ @ @ @ @ - @ @ - - - - - - - - - @ @ - @ @ - - - - - @ - - @ @ - - @ @ - - @ - - - - - - @ @ @ @ - - - @ @ @ - @ @ @ - - - - - - - - - -|
|- - - - - - - - @ - - - @ @ @ @ - - - - - - - @ @ @ @ @ @ @ @ @ - - - - - - - - - - - - @ @ - - @ @ - @ @ - @ @ - - @ @ - @ @ - - - - - - @ @ @ - - - - @ @ - @ @ - - - - @ @ @ - @ - @ @ @ - - - - @ -|
|- - - - - - - - @ - - - @ @ - - - - - - - - - @ - - @ @ - - @ @ @ @ - - - - - - - - - - @ @ - - @ - - @ @ @ @ @ - - @ @ @ @ @ - - @ @ @ - - @ @ @ - - - @ @ - @ @ - - - - - - - - - - - - - - - - - @ -|
|- - - - - - - - - - - - - - - - @ @ @ @ - - @ @ @ - - @ - - - - @ @ - - - - - - - - - - - @ @ @ @ @ - - @ @ - - - - - @ @ - @ - - - @ @ @ @ @ @ @ @ @ @ @ - - - - - - @ @ @ @ - - - - - - @ @ @ @ @ @ -|
|- - - - - - - - - - - - - - - @ @ @ - @ @ @ @ @ @ - @ @ - - - - @ - - @ @ @ @ - - @ @ - - @ @ @ - @ @ @ @ - - - - - - @ - - - - - - @ @ @ @ - @ - - - - - - - @ @ @ @ @ - @ @ @ - @ @ @ @ @ @ @ @ - @ -|
|- - @ @ @ - - - - - - - - - - - - - - - - @ @ - @ @ @ @ - - - - @ - - @ @ @ @ - - @ @ - - @ @ - - - - - - - @ - @ - @ @ - - @ @ - - - - - @ - @ - @ - - - - - - - @ @ @ - - - @ - - - - - - - @ @ - @ -|
|@ @ @ @ @ - - - - - - - - - - - - - - - - - @ @ @ @ - @ @ @ - - @ - @ @ - - - - - @ - - - - @ - @ @ - - - - @ - @ - @ - - @ @ @ - - - - - @ - @ - @ @ @ @ - - - - - - @ - - - @ - - - - - @ - - - - - -|
|- @ @ @ @ - - - - - @ - - - - - - - - - - - - - - @ - - - - - - - - @ @ - - - @ @ @ - - - @ @ @ @ @ @ @ - - @ - @ @ @ @ @ @ - - - @ @ @ - @ - @ - @ - - - - - @ @ @ - @ @ - - @ @ - @ - - @ @ @ - - - @|
|- @ - @ @ - - - - - @ - - - - - - - @ - - - - - - @ - - - - - - @ @ @ - - - - @ @ - - - - - - - - - - @ @ @ @ - - - - - - @ - - - @ @ @ - - - @ - @ @ @ @ @ - @ - @ @ @ @ - - @ @ - @ - - @ @ @ - - - @|
|- @ @ @ @ - - - - - @ - - - - - - - @ - - - @ @ @ @ - - - - @ - @ @ @ @ @ @ - @ @ - - - - - - - - - - - - - - - - - - - - - - - - - - - - - @ @ - - - @ @ @ @ @ - - - @ @ - - - @ @ @ @ - @ @ - - @ - -|
|- - @ @ @ @ - @ @ - - - - - - @ - @ @ @ @ @ @ - - @ - @ @ @ @ - - - @ - - @ - @ @ @ - - - - @ - - - - - - - - - - - @ @ @ - - @ @ @ - - - @ @ - - - @ @ - @ @ @ @ - - @ - - - @ @ @ @ @ - @ @ - - @ - @|
|- - @ - - @ @ @ @ - - - @ @ - @ - @ - @ @ @ @ - - @ @ @ - - @ - - - @ - @ @ - - @ @ @ @ @ - @ - @ @ @ @ - - - @ @ @ @ - - - - - - - - - - @ @ @ - - @ @ @ @ - - - - @ @ - - - @ - - - @ - @ @ @ @ @ - @|
|@ - @ - @ @ @ @ - - - - @ @ - @ - @ @ @ @ @ - - - - @ @ - - - - - - - - @ @ - - - - - - @ @ @ @ @ - - - - - - - - @ @ - @ @ @ - - @ @ @ - - - @ - - @ @ - - - - @ @ @ @ @ - - @ - - - - - @ @ @ @ - - @|
|@ - @ - @ @ @ - - - - - - @ - @ - @ @ - @ - - - @ @ @ @ - - - - - - - - @ - - - - - - - @ @ @ @ @ - - @ @ @ - - - - @ @ @ @ @ - - - - - - - - @ - - @ @ @ @ - - - @ @ @ @ @ - - - - - - - @ @ @ - - @ @|
|@ - - - - - - - - @ @ - - @ @ @ - - @ - @ @ @ - @ @ @ - - - @ - - - - - @ - - - - - - - @ @ - - - - @ @ - - - - - - @ @ - - - - - - - @ @ - - @ - - @ @ @ - - - - @ @ - - @ @ @ @ - - - @ @ @ - - @ @ @|
|- - - - - - - - - @ @ - - @ @ @ - - @ - @ @ @ - - @ @ @ - - @ - - - - - - - - @ @ @ - - - - - - @ @ @ @ @ @ - - - - - - - @ @ - @ @ @ @ @ - - - - - @ @ @ @ - - @ @ @ @ @ @ - - @ - - - @ - @ @ @ @ - -|
|- - - - - - - - @ @ - - - - - - - - @ - - - - - - - - - - @ @ - - - - - - - - - - - - - - - - - @ @ - - @ @ @ @ @ - - - - @ @ - - - - - - - - @ - @ @ @ - - - - @ @ @ @ @ @ @ - @ @ - - @ @ @ @ @ @ - -|
|- - @ @ @ - - - @ - - - - - - - - - @ @ @ @ - - - - - - @ @ @ - @ @ - - - - @ - @ @ @ - - - @ @ @ - - - - - - @ @ - - - - @ @ @ - - @ @ @ - - @ - - - - - - - - - @ @ - - @ @ - @ @ - @ @ @ - - @ @ - -|
|- - - - - - - - @ - - - - - - @ @ - @ - - - - - @ @ @ - @ @ @ - @ @ - - @ @ @ - - - - - @ @ @ - - - @ @ @ @ @ @ @ - - - - - - @ - - - - - - - @ @ @ @ @ - - - @ - @ @ - - @ @ - - @ - @ - @ - - - - - -|
|- - - - - - - - - - - - @ @ @ @ @ - - - @ @ @ @ @ @ - - - - - - - - - - @ @ @ - - - - - @ @ @ @ @ @ @ - @ @ - @ - - - - - @ - @ - - - - - @ @ @ - @ @ @ - - - @ - - - - @ @ - - - - - @ - - - - - - - -|
|- - @ @ @ - - - - - - - - - - - @ - - - - @ @ @ @ @ - - @ @ @ - - @ @ - - - - - - - - - - @ @ @ @ @ - - @ @ - @ @ @ @ - - @ - - - @ @ @ - - @ - - - - - - - - @ - - @ @ @ @ - - - - @ @ - - - @ @ @ - -|
|- @ @ - @ - - - - - - - - @ - - @ - - - - @ @ - - @ @ @ @ - @ @ @ @ @ - - @ @ @ @ @ - - - @ @ @ - @ @ - - - - @ - - @ - - @ - - @ @ - - - - @ - - - - - - - - - - - @ @ @ @ - - - - @ @ - - - - - - - -|
|- @ @ @ @ - - - - - - - - @ - - - - - - - @ @ @ - - - - - - @ - - - - - - @ @ @ @ @ @ @ - - @ @ @ @ @ @ - - - - - - @ - - - - - @ - - - - - @ @ - - - - - - - - - @ @ - @ @ - - - @ @ - - - - - - - - -|
|@ @ - - @ - - - - @ @ @ @ @ - - - - - - - - - @ - @ @ @ @ - @ - - - - - @ @ @ - - @ @ @ - - @ @ @ - @ @ - - - - - - @ - - - - - @ - - - - - @ @ - - - - - @ @ @ - @ @ - - @ @ @ @ @ @ @ @ @ - - - - - -|
|@ - - - - - - - - @ @ @ @ @ @ - - - @ @ @ @ - @ @ @ - - @ @ @ - - @ @ - - - - - - @ @ @ @ @ @ @ @ @ @ @ - - - - - - @ - - - - - @ @ @ - - - @ @ - - - - - - - - - - - - @ @ @ - - - - - @ - - - - - - -|
|@ - - - - - - - @ @ @ - @ @ @ - - - @ - - @ @ @ - - - - @ @ @ - - @ @ - - - @ @ @ @ @ @ @ @ @ - @ @ @ @ @ - - - - - @ - - - - - - - - - - - - @ - - - - - - - @ - - - - - - - - - - - - @ - - - - - - @|
|- - - @ @ @ @ - - - - - @ @ @ @ - - @ - - @ @ - - - - - @ @ @ @ - @ @ @ - - @ - - - @ @ @ @ @ @ @ - @ - - - - - - - @ - - - - - - - - - - @ - - - - - - - - - @ - - - @ @ @ - - - - - - @ - - - - - - @|
|- - - - @ @ @ - - - - - - @ - @ @ @ @ - - - - - @ @ - - @ - - @ @ @ - @ @ @ @ - @ @ @ - - @ @ - - - @ @ - @ @ - @ @ @ - - - - @ - - @ @ @ @ - - - - @ @ - - - @ - - @ @ @ - - - - - - - - - - - - - - -|
|- @ @ - @ @ @ @ - - @ @ @ @ @ @ @ - - - @ @ - - @ @ @ @ @ @ - @ @ @ @ @ @ @ @ - - - - - - @ @ - - - @ @ - @ @ - @ @ @ @ - - - @ - - - - @ @ @ @ @ - @ @ - - @ @ - - - - @ - - @ @ @ @ - - - - - - - - -|
|- @ @ @ @ @ - - - - - - - - @ - @ @ @ @ @ @ - - - - @ @ - @ @ @ @ @ @ @ - - - - - - - - @ @ @ @ - - - @ - - @ - - - @ @ @ @ - @ - - - - @ @ @ @ @ - @ @ - - @ @ @ - - - @ @ @ @ @ @ @ @ - @ @ - - - - -|
|- - - @ - @ - - - - @ - @ @ @ - @ @ - @ @ - - - - - - - - @ - - - @ @ @ - - - - - - - - @ @ - - - - - @ - - @ - - - - - @ @ - - - - @ @ @ - - - - - @ @ - - - - - - - - @ @ @ - - - @ @ @ @ @ - @ @ - -|
|- - @ @ @ @ @ - - - @ - @ @ @ @ @ @ @ @ @ - - - - - - - - @ @ @ - - @ - - - @ @ @ @ @ - - - - @ @ - @ @ - @ @ - - @ @ - - - - - - - - - - - - - - - - - - - - - - - - @ @ @ @ - - - @ @ @ - @ - @ @ - -|
|- - - - - - @ @ @ - @ @ @ @ @ @ @ @ @ - @ - - - - - @ - @ @ - - - - @ @ @ @ @ - - - - - @ @ @ @ @ @ @ @ @ @ - - - @ @ - - - - - - - - - - - - @ @ @ - - - @ - - - - - - - - - - - - - - - - @ - @ - - -|
|- - - - - - @ - - - - - - @ @ @ @ @ @ @ @ @ @ - @ @ @ - @ - - @ @ @ @ - - - - - - - @ - - - - - - @ - - @ @ - - - - @ - @ @ - - @ @ @ - - - - - @ @ @ @ @ @ - - - - @ @ @ - - @ @ @ - - - - @ - @ - - @|
|- - - - - - @ - - - - - - @ @ @ - @ @ @ @ @ @ - @ @ @ @ @ - - @ - - - - @ @ @ - - - @ - @ @ @ - - @ - - @ @ - - - - @ @ @ @ - - - - @ @ @ - @ @ @ - @ - - @ - - @ - @ @ @ - - - - - - - - - @ - @ - - @|
|- - - - - - - - - - - - - - @ @ - @ @ @ @ @ - - - @ - - - - - @ - - - - @ - - - - @ @ - - - - - @ @ - - @ @ @ - - - @ @ - - - - - - - - - - - - - - @ - - - - - @ - @ - - - - - - - - - - - @ @ @ @ @ @|
|@ @ - - - - - - - - - - - - @ @ @ @ - - @ - - @ - @ - - - - - - - - - - @ - - - @ @ @ @ @ @ @ @ @ @ @ - - - - - - - @ @ - - - - - - - - - - - - - - @ @ @ - @ @ @ - @ - - - @ @ @ - - @ @ - @ - @ @ @ @|
|@ @ @ @ - - @ @ @ @ - - @ - - @ @ @ - - @ - - @ @ @ @ - - - - @ @ - - @ @ @ - - - - @ - - - - - - - @ - - - - - - - - - - - - - - - @ @ @ - - - - - - - @ - @ @ - - - - - @ @ @ @ @ @ @ @ - - - - @ @ @|
|@ @ @ @ - - @ - @ @ @ @ @ - - @ @ @ @ - - - - @ - - - - - - @ @ @ - - @ @ - - - - - @ - - - - - - - @ - - @ @ @ - - - - - - @ @ - @ @ @ @ - - - - - - - @ - - - - - - - - @ @ @ @ @ @ - - - - - - - - -|
|@ @ - @ - - @ - - - - - @ - - @ - - @ - - - - @ - - @ @ - - @ @ @ - - @ @ @ - - - - @ @ @ - - - - - @ - @ @ - - - - - - @ - @ @ - @ @ @ @ @ @ - - - - - @ - - @ @ @ @ - @ @ @ @ @ @ - - - - @ @ @ @ @ @|
|- - - @ @ @ @ - - - - - - - - @ - - @ - @ @ @ @ @ - @ @ @ @ @ @ - - - @ @ @ - - @ @ @ @ - - - - @ @ @ - @ @ @ @ - - - - @ @ @ @ @ @ @ @ @ @ @ - - - - - - - - @ @ @ @ - @ @ - - @ @ - - - @ @ @ - @ @ @|
|- - - - @ @ @ - @ - @ @ - - - @ @ - @ - @ @ - - @ @ @ @ - @ @ @ - - - - - @ @ @ @ @ - @ - - - - - - - - @ - @ - - - - - @ - - - - @ - @ @ @ @ - - - - - @ @ - - - @ @ @ @ @ @ @ @ @ @ - - @ - @ - @ @ @|
|@ @ @ - - - - - @ @ @ @ - @ - @ @ - - - @ @ - - - - - - - - @ @ - @ @ - - - - - - - - @ - - - - - - - - @ @ @ - - - - - @ @ @ @ @ @ - @ @ - - - - - - - @ @ - - - - @ - - - - - @ @ @ - - @ - @ - @ @ -|
|- - @ @ @ - - @ @ @ @ @ - @ - @ @ - - - - - - - - - - - @ @ @ @ @ @ @ - - @ - @ - - - @ - @ @ - - - - - @ @ @ @ - - - - - - - - - @ @ @ @ @ - - - - @ @ @ @ - - - @ @ - - - - - - @ @ - - - - - - - @ -|
|- - - - - - - @ - @ @ @ @ @ @ @ - - - - - - - - - - - - - - @ - @ @ @ @ - @ - @ - - - - - @ @ - - - - - - - - @ @ @ - - - - - @ @ @ - - - @ - - - @ @ - - @ - - - @ @ @ - - - @ @ @ @ - - @ @ @ - - @ -|
|- - - - - - - @ - @ @ @ @ @ @ @ - - - - - @ - - - - - - - - @ - @ - - @ - @ - @ - - - - - - - - - - - - - @ @ @ @ @ - - - - - - @ - - - @ @ @ - - @ @ - - @ @ @ @ @ @ @ - - @ @ @ @ - - - @ - @ @ @ @ -|
|- - - - - - - - - - @ - @ @ @ @ - - @ @ - @ - - - - - @ - @ @ - - - - @ - - - - - - - - - - - - - @ @ - - - - - - - - - - @ @ @ @ - - - - @ - - - - - - - @ @ @ @ - - @ @ @ @ - @ @ @ - - @ - - @ - @ -|
|- - - - - - - - - - @ - - @ @ @ - - @ @ - @ @ - - - @ @ - @ @ - - - - @ - @ - - @ @ - @ @ @ - - - @ @ - - - - - - - - - - - - @ @ @ @ @ @ @ @ - - - - - - - @ - @ @ @ @ @ @ @ - @ @ @ @ @ @ - - @ - - -|
|- - - - - - - - - - @ - - - - @ @ @ @ @ @ @ @ - - - @ @ - - - - @ @ @ @ - @ - - @ @ - - @ @ @ - @ @ @ - - - - - - - - - - - - @ @ @ @ @ - @ @ - - - - - - @ @ - @ @ @ - @ @ @ - @ @ @ @ @ @ - @ @ @ @ @|
|- - - - - - - - - @ @ - - - - @ @ @ @ @ @ @ @ - - @ @ @ - - - - - - @ @ - @ - - - @ - - @ @ @ - @ @ @ - - - - @ @ - - - - - - @ - - @ @ @ @ @ - - - @ @ - @ - - - @ @ - - - @ @ @ @ - - - @ @ @ @ @ - -|
|- @ @ @ @ @ @ @ @ @ @ - - - - @ @ - @ @ @ @ @ - - - - - - - - - @ @ @ - - - - - - @ - - @ - - - - @ @ @ @ - - @ @ - - - - - - - - - @ @ @ - @ - @ @ @ @ @ @ - @ - - @ @ @ - - @ - - - - - @ @ @ @ @ @ @|
|- @ @ @ @ @ @ - - - - - - - - - - - @ @ @ @ @ @ @ @ @ - - - @ @ @ @ @ - - - - - @ @ - @ @ - - - - - - - - - - @ - - - - @ @ - - - - @ @ @ - @ - - @ @ @ @ @ - @ - @ @ @ @ - - @ @ @ @ @ - @ @ - - - @ @|
|- @ @ @ @ @ @ @ @ - - @ - - - - - @ @ @ - - @ @ @ @ @ - - - @ @ - - - - - - - - @ - - @ @ - - - - - - @ @ - - @ @ - @ @ @ @ @ - - @ @ @ - - - - @ @ - @ @ - - @ - @ @ @ - - - - - - @ @ - @ @ @ - - - -|
|- @ - - - @ - @ @ - - @ - - - - - - - - - - @ @ @ - - - - - - - - - - - - - - - @ @ @ @ - - - - - - - @ @ @ - - @ - - - - - - - - @ - @ @ @ - - @ @ - - - - - - - @ @ @ - @ @ @ - @ @ @ - @ @ @ - - - -|
