100 20
|- - - - - - - - - - - - - - @ - - @ - - - - - - - - - - - - @ @ @ - @ - - - - - - - - - - - - - - - - - @ @ - - - - @ - - - @ - - - - - - - - - - - - @ @ - @ - - - - - @ @ - - - - - - - - - - - - - -|
|- - - - - - - - - - - - - - @ - - @ - - - - - - - - - - - - @ @ @ - @ - - - - - - - - - - @ - - - - - - @ @ - - - - @ - - - @ - - - - - - @ - - - - - @ @ - @ - - - - - @ @ - - - - - - - - - - - - - -|
|- - - - - - - - - - - - - @ @ @ - @ - - - - - - - - - - - - @ @ @ - @ @ @ - - - - - - - - @ - - - - - - @ - - - - - - - - @ @ @ - - - - @ @ @ - - - - - - - @ - - - - - - - - - - - - - - - - - @ @ - -|
|- @ - - - - - - - @ @ @ - @ - - - - - - - - - - - - - - - - - @ @ - - @ @ - - - @ - - - - @ - - - - - - - - - @ @ - - - - - @ - - - - - @ @ @ - - - - - - - - - - - - - - - - - - - @ - - - - - @ @ - -|
|- @ - - - - - - @ @ @ - - @ - @ @ @ @ - - - - - - - - - - @ @ @ - - @ @ @ @ - - @ - - - - @ - @ @ - @ @ - - - @ @ - - - - - @ - - - @ @ @ @ @ @ @ @ - @ @ @ - - - - - - - - - - - @ @ - - - - - - - - -|
|- @ - - - - @ @ @ - - - - @ - - - @ @ - - - - - - - - - - - - - - - - - - @ @ @ @ - - - - - - @ @ - @ @ - - - - - - @ @ @ - @ - - - @ @ @ - - - - - - - - - - - - - - - - - - - - @ @ - - - - - - - - -|
|- - - - - - - - - - - - - @ @ @ - @ @ @ - - - - - - - @ - - - @ - @ @ - - @ @ @ @ @ @ - - - - @ @ @ @ @ @ @ - - - - - @ - - @ - - - @ - @ - - - - - - - - - @ @ @ @ @ - - - - - - - - - - - - - - - @ @|
|- - - @ @ - @ @ - - - - - - - - - - - - - - - - - - - @ - @ @ @ - @ @ - - - - @ @ @ @ @ - - - - - - - - - @ @ @ - - @ @ - - - - - - @ - - - - - - - - - - - - - - @ @ - - @ @ - - @ @ @ @ @ @ - @ @ @ @|
|- - - @ @ - @ @ @ @ @ - - @ @ - - @ @ - - - - - - - - @ - @ @ @ - - - - - - - - - - @ @ @ @ - - - - - - - - @ @ @ - @ @ - - @ @ @ @ @ - - - - - - @ - - - - - @ @ @ @ - @ @ @ - - @ @ @ @ - - - @ - - -|
|- - - - - - - @ - @ @ @ - @ @ - - @ @ @ - - - - - - - - - @ @ @ @ @ @ @ @ - - - - - - - - - - - - - - - - @ @ @ @ - @ @ - - @ @ - - - - - - - - - @ - - - @ @ @ - - - - @ @ - - - - @ @ - - - - @ @ @ -|
|- - - - @ - - @ @ @ - - - - - - @ @ @ @ - - - - - - - @ @ @ - @ @ - - @ @ - - - - - - - - - - - - - - - @ @ - @ @ @ @ @ @ @ @ @ - - @ @ - - - - - @ @ @ @ @ @ @ - - - - - - - - @ @ @ - - - - - @ - - -|
|- - - - @ - - @ @ - - - - - - - - - @ @ - - @ @ @ - - @ @ - - @ @ - - @ @ - @ - - - - - - - - - - - - - @ @ - - - - - - @ @ @ - - - @ @ - - - - - @ - @ @ @ - @ @ - @ @ - - - - - - - - - - - @ @ - @ @|
|- - @ @ @ - - @ @ - - - - @ - - - @ @ - - - - - - - - - @ - - - - - - @ - - @ - - - - @ @ @ - - - - - - - @ @ @ - - - - - @ @ - @ @ @ @ @ @ - - - - - - @ @ @ @ @ @ @ @ @ @ - - - - - - - - - @ @ - @ @|
|- - @ @ - - - - - - - @ @ @ - - - @ @ - - - - - @ @ @ - - - @ @ @ @ - @ - - @ @ @ @ - @ @ @ @ @ - - - - - - - - - - - - - @ @ - @ @ - - @ @ - @ - @ @ @ @ @ @ @ @ - @ @ @ @ - @ @ @ - - @ @ - - - - @ @|
|- - - - - - - @ - - - @ @ @ - - - @ - - @ @ - - @ @ @ - - - @ @ - - - @ - - - - @ - - - @ @ @ - - - - - - - - - - - - - - - - - - - - - - - - @ - - - - @ @ @ @ @ @ @ - @ @ @ @ - - - - @ @ - @ - @ @ @|
|@ @ @ @ - - - @ @ - - - - @ @ - - - - @ @ @ - - - - - - - - - - - - - @ - - - - @ @ - @ @ - @ - - - - - - - - - - - @ @ @ - - - - - - - @ @ @ @ @ @ @ - - - @ @ @ - - - @ @ @ - - @ @ - @ @ @ @ @ @ - @|
|@ @ - - - - - @ @ - - - - @ @ - - - - @ @ @ - - @ @ @ - - - - - - @ - - - - - - @ @ - @ - - @ - - - @ @ - @ @ - - - - - - - - - - - - @ @ @ @ @ @ - - - - - @ @ @ @ @ - - - - - - @ @ - @ @ @ @ @ - - @|
|@ @ - - - - - @ @ - - - @ @ @ - - - @ @ @ @ - - - - @ @ - - - - - @ - - - - - - - @ @ @ - - - - - - @ @ - @ @ - @ - - - - @ @ - - - - @ @ - - @ @ - - - - - - @ @ - - - - - - - - - @ @ @ @ - @ @ - - -|
|@ @ - - - - - @ - - - - @ - @ @ @ @ @ @ @ @ - - - - @ @ - - - - - @ - - - - - - - @ @ - - @ - - - - - - - @ @ - @ - - - @ @ @ - - - - @ @ @ @ @ @ @ - - - @ @ @ @ - - - - @ @ - - - - - @ @ @ @ @ @ @ -|
|@ @ - - - - - @ @ @ @ - @ - @ @ - - - @ @ - - - - - - @ @ - - - - @ - - - - - @ @ @ @ - - @ - - @ @ - - - - - - @ - - - @ @ @ - - - - @ @ - - - - - - - - @ @ - - - - - - @ @ - - - - - - - - - - - - -|
