30 30
|@ - - - - - - - - @ @ - - - - - - - @ @ @ @ - - @ @ @ @ - -|
|@ - - @ @ @ - @ @ @ @ @ - - - - - - @ @ @ @ - - @ - - @ - -|
|@ - - - - - - @ @ @ - @ - - @ @ - - - - @ @ @ @ @ - - @ @ -|
|- - - - - - - - @ @ @ @ @ @ @ @ - - - @ @ - @ @ @ - - @ @ -|
|- - - - - - - @ @ - @ @ - - @ @ @ - - @ @ - - @ - - - @ @ -|
|- - @ @ @ - - @ - - @ @ - - - - @ @ @ @ @ - - @ - - - - - -|
|- - - - - - - @ - - @ @ @ - - - - @ @ - @ @ - - - - @ - - -|
|- - @ - - @ @ @ - @ @ @ @ - - - - - - - @ @ @ - - @ @ - - @|
|- - @ - - @ @ - - @ @ - @ @ - - - - - @ @ @ @ - - @ @ @ - @|
|- @ @ - - @ @ - - @ @ @ @ @ - - - @ @ @ - - @ - - @ @ @ - @|
|- @ @ - - @ @ - - @ - - - - - - - - - @ - - @ @ @ @ @ @ - @|
|- - @ @ @ @ @ - @ @ - @ - @ @ @ - - @ @ @ @ @ - @ @ - - - @|
|- @ @ @ - - - - @ @ @ @ - - @ @ @ @ @ @ @ @ @ @ @ - - - - -|
|- @ - - - - - - - @ @ @ - - @ - @ @ @ @ @ @ - @ @ @ @ - - -|
|- @ @ - @ - - - - - - - - - - - - @ - - - @ @ @ @ - - - - -|
|- @ @ @ @ - - - - - - - - - - - - @ @ @ @ @ - - @ - - - - -|
|- - - @ @ - - - - @ @ @ @ @ - - - - - @ @ @ - - @ - - - - -|
|- - - @ @ - - - - @ - - @ @ - - - - - @ - @ - - @ @ @ - - -|
|@ @ - - - - - - - @ @ - - - - - - - - @ - - - - - @ @ - - -|
|@ @ - - - - - - @ @ @ - - @ @ @ - - - - - - - - - - - - @ @|
|- - - - - - - - @ @ @ - - - - - - - - - - - - - - - - - - -|
|@ - - @ @ - - @ @ @ @ - - - @ @ - - - - - - - - - @ @ @ @ @|
|@ @ @ @ @ - @ @ - @ @ @ - - @ @ - - - - - - - @ @ @ - - - -|
|@ - - - - - @ @ - - - @ - - - - - - @ @ - - - - - - - - @ @|
|@ @ - @ @ - @ - - - - @ - @ @ @ - - @ @ @ @ @ - - - - - @ @|
|@ @ - @ @ @ @ - - - - - - @ @ - - - - - @ @ @ @ @ - - @ @ @|
|@ - - @ @ @ @ @ - - - @ @ @ @ - - - - - @ @ - - @ @ - @ - -|
|@ @ @ @ - - - @ @ - - @ @ @ @ @ @ - - - @ @ @ - - @ - @ - -|
|- - - @ - - - @ @ - - @ @ @ - - - - - - @ @ - - @ @ - @ - -|
|- - @ @ - - - - - - - @ - - - - - - - - @ @ - - @ - - - - -|
