30 30
|- - - - - - @ @ - - - - - - - - - - - - - - - - - - - - - -|
|- - - - - - @ @ - - - - - - - - - - - - - - - - - - - - - @|
|- - - - - - - - - - - - - - - - - - - - - - - - - - - - - @|
|- - - - - - - - - - @ - - - - - - - - - - - - - - - - - - @|
|- - - - - - - - - - @ - - - - - - - - - - - - - - - - - - -|
|- - - - - - - - - - @ - - - - - - - - - - @ - - - - - - - -|
|- - - - - - - - - - - - - - - - - - - - - @ - - - - - - - -|
|- - - - - - - - - @ - - - - - - - - - - - @ - - - - @ @ - -|
|- - - - - - - - - @ - - - - - - - - - - - - - - - - @ @ - -|
|- - - - - - - - - @ - - - - - - - - - - - - - - - - - @ @ @|
|- - - - - - - - - - - - - - - - - - - - - - - - - - - - - -|
|- - - - - - - - - - - - - - - - - - - - - - - - - - - - - -|
|- - - - - - - - - - - - - - - - - - - - - - - - - - - - - -|
|- - - - - - - - - - - - - - - - - - - - - - - - - - - - - -|
|- - - - - - - - - - - - @ @ @ - - - - - - - - - - - - - - -|
|- - - - - - - - - - - - - - - - - - - - - @ @ - - - - - - -|
|- - - - - - - - - - - - - - - - - - - - - @ @ - - - - - - -|
|- - - - - - - - - - - - - - - - - - - - - - - - - - - - - -|
|- - - - - - - - - - - - - - - - - - - - - - - - - - - - - -|
|- - - - - - - - - - - - - - - - - - - - - - - - @ @ - - - -|
|- - - - - - - - - - - - - - - - - - - - - - - - @ @ - - - -|
|- - - - - - - - - - - - - - - - - - - - - - - - - - - - - -|
|- - - - - - - - - - - - - - - - - - - - - - - - - - - - - -|
|- - - - - - - - - - - - - - - - - - - - - - - - - - - - - -|
|- - - - - - - - - - - - - - - - - - @ @ - - - - - - - - - -|
|- - - - - - - - - @ @ - - - - - - - @ @ - - - - - - - - - -|
|- - - - - - - - - @ @ - - - - - - - - - - - - - - - - - - -|
|- - - - - - - - - - - - - - - - - - - - - - - - - - - - - -|
|- - - - - - - - - - - - - - - - - - - - - - - - - - - - - -|
|- - - - - - - - - - - - - - - - - - - - - - - - - - - - - -|
