100 100
|- - - - - - - - - - - - - - - - - @ - - - - - - - - - - - - - - - - - - - - - - - - - - - - - - - - - - - - - - - - - - - - - - - - - - - - - @ @ - - - @ - - - - - - - - - - - - - - - - - - - - - - @|
|@ @ @ - - - - - - - - - - - - - - @ - - - - - - - - - - - - - - - - - - - - - - - - - - - - - - - @ @ - - - - - - - - - - - - - - - - - - - - @ @ @ - - @ - - - - - - - - - - - - - - - - @ @ @ - - - @|
|- - - - - - - - - - - - - - - - - - - - - - - - - - - - - - - - - - - - - - - - - - - - - - @ @ - @ @ - - - - - - - - - - - - - - - - - - - - - @ @ - - - - - - - - - - - - @ @ - - - - - - - - - - - -|
|- - - - - - - - - - - - - - - - - - - - - - - - - - - - - - - - - - - - - - - - - - - - - - @ @ - - - - - - - - - - - - - - - - - - - - - - - - - - - - - - - - - - - @ @ @ @ @ - - - - - - - - - - - -|
|- - - - - - - - - - - - - - - - - - - - - - - - - - - - - - - - - - - - - - - - - - - - - - - - - - - - - - - - - - - - - - - - @ @ - - - - - - - - - - - - - - - - - - - - - - - - - - - - - - - - - -|
|- - - - - - - - - - - - - - - - - - - - - - - - - - - - - - - - - - - - - - - - - - - - - - - - - - - - - - - - @ - - - - - - - @ @ - - - - - - - - - - - - - - - - - - - - - - - - - - - - - - - - - -|
|- - - - - - - - - - - - - - - - - - - - - - - - - - - - - - - @ @ - - - - - - - - - - - - - - - - - - - - - - - @ - - - - - - - - - - - - - - - - - - @ @ @ - - - - - - - - - - - - - - - - - - - - - -|
|- - - - - - - - - - - - - - - - - - - - - - - - - - - - - - - @ @ - - - - - - - - - - - - - - - - - - - - - - - @ - - - - - - - - - - - - @ @ @ - - - - - - - @ - - - - - - - - - - - - - - - - - - - -|
|- - - - - - - - - - - - - - - - - - - - - - - - - - - - - - - - - - - - - - - - - - - - - - - - - - @ @ - - - - - - - - - - - - - - - - - - - - - @ @ - - - - @ - - - - - - - - - - - - - - - - - - - -|
|- - - - - - - - - - - - - - - - - - - - - - - - - - - - - - - - - - - - - - - - - - - - - - - - - - @ @ - - - - - - - - - - - - - - - - - - - - - @ @ - - - - @ - - - - - - - - - - - - - - - - - - - -|
|- - - @ @ - - - - - - - - - - - - - - - - - - - - - @ @ - - - - - - - - - - - - - - - - - - - - - - - - - - - - - - - - - - - - - - - - - @ @ @ - - - - - - - - - - - - - - - - - - - - - - - - - - - -|
|- - - @ @ - - - - - - - - - - - - - - - - - - - - - @ @ - - - - - - - - - - - - - - - - - @ @ - - - - - - - - - - - - - - - - - - - - - - - - - - - - - - - - - - - - - - - - - - - @ @ - - - - - - - -|
|- - - - - - - @ @ @ - - - - - - - - - - - - - - - - @ - - - - - - - - - - - - - @ - - - - @ @ - - - - - @ @ - - - - - - - - @ @ - - - - - - - - - - - - - - @ - - - - - - - @ - - - @ @ - - - - - - - -|
|- - - - - - - - - @ - - - - - - - - - - - - - - - - - - @ - - - - - - - - - - - @ - - - - - - - - - - - @ @ - - - - - - - - @ @ - - - - - @ @ @ - - - - - - @ - - - - - - - @ - - - - - - - - - - - - -|
|- - - - - - - - - @ - - - - - - - - - - - - - - - - - - @ @ @ - - - - - - - - - @ - - - - - - - - - - - - - - - - - - - - - - - - - - - - - - - - - - - - - @ - - - - - - - @ - - - - - - - - - - - - -|
|- - - - - - - - - @ @ - - - - - - - - - - - - - - - - - @ @ @ - - - - - - - - - - - - - - - - - - - - - - - - - - - - - - @ - - - - - - - - - - - - - - - - - - - - - - - - - - - - - - - - - - - - - -|
|- - - - - - - - - - @ - - - - - - - - - - - - - - - - - - - - - - - - - - - - - - - - - - - - - - - - - - - - - - - - - - @ - - - - - - - - - - - - - - - - - - - - - - - - - - - - - - - - - - - - - -|
|- - - - - - - - - - @ - - - - - - - - @ - - - - - - - - - - - - - - - - - - - - - - - - - - - - - - - - - - - - - - - - - @ - - - - - - - - - - - @ - - - - - - - - - - - - - - - - - - - - - - - - - -|
|- - - - - - - - - - @ @ @ @ - - - - - @ - - - - - - - - - - - - - - - - - - - - - - - - - - - - - - - - - - - - - - - - - - - - - - - - - - - - - @ - - - - - - - - - - - - - - - - - - - - - - - - - -|
|- - - - - - - - - - - - - - - - - - - @ - - - - - - - - - - - - - - - - - - - - - - - - - - - - - - @ @ - - - - - - - - - @ @ - - - - - - - - - - @ - - - - - - - - - - - - - - - - - - - - - - - - - -|
|- - - @ @ - - - - - - - - - - - - - - - - - - - - - @ @ @ - - - - - - - - - - - - - - @ @ - - - - - @ @ - - - - - - - - - @ @ - - - - - - - - - - - - - - @ - - - - - - - - - - - - - - - - - - @ - - -|
|- - - @ @ - - - - - - - - - - - - - - - - - - - - - - - - - - - - - - - - - - - - - - @ @ - - - - - - - - - - - - - - - - - - - - - - - - - - - - - - - - @ - - - - - - - - - - - - - - - - - - @ - - -|
|- - - - - - - - - - - - - - - - - - - - @ @ @ - - - - - - - - - - - - - - @ - - - - - - - - - - - - - - - - - - @ @ - - - - - - - - - - - - - @ @ - - - - @ - - - - - - - - - - - - - - - - - - @ - - -|
|- - - - - - - - - - - - - - - - - - - - - - @ @ @ - - - - - - - - - - - - @ - - - - - - - - - - - - - - - - - - @ @ - - - - - - - - - - - - - @ @ - - - - - - - @ @ @ - - - - - - - - - - - - @ @ @ - -|
|- - - - - - - - - - - - - - - - - - - - - - - - - - - - - - - - - - - - - @ - - - - - - - - - - - - - - - - - - @ @ - - - - - - - - - - - - - - - - - - - @ @ @ @ - - - - - - - - - - - - - - - - - - -|
|- - - - - - - - - - - - - - - - - @ - - - - - - @ @ @ @ @ - - - - - - - - - - - - - - - - - - - - - - - - - - - - - - - - - - - - - - - - - - - - - - - - - - - - - - - - - - - - - - - - - - - - - - -|
|- - - - - - - - - - - - - - - - - @ - - - - - - - - - @ @ - - - - - - - - - - - - - - - - - - - - - - - - - - - - - - - - - - - - - - - - - - - - - - - - - - - - - - - - - - - - - - - - - - - - - - -|
|- - - - - - - @ - - - - - - - - - @ - - - - - - - - - - - - - - - - - - - - - - - - - - - - - - - - - - - - - - - - - - - - - - - - - - - - - - - - - - - - - - - - - - - - - - - - - - - - - - - - - -|
|- - - - - - - @ - - - - - - - - - - - - - - - - - - - - - - - - - - - - - - - - - @ @ - - - - - - - - - - - - - - - - - - - - - - - - - - - - - - - - - - - - - - - - - - - - - - - - - - - - - - - - -|
|- - - - @ - - @ - - - - - - - - - - - - - - - - - - - - - - - - - - - - - - - - - @ @ - - - - - - - - - - - - - - - - - - - - - - - - - - - - - - - - - - - - - - - - - - - - - - - - - - - - - - - - -|
|- - - - @ - - - - - - - - - - - - @ @ - - - - - - - - - - - - - - - - - - - - - - - - - - - - - - - - - - - - - - - - - - - - - - - - - - - - - - - - - - - - @ - - - - @ @ @ - - - - - - - - - - - - -|
|- - - - @ - - - - - - - - - - - - @ @ - - - - - - - - - - - - - - - - - - - - - - - - - - - - - - - - - - - - - - - - - - - - - - - - - - - - - - - - - - - - @ - - - - - - - - - - - - - - - - - - - -|
|- - - - - - - - - - - - - - - - - - - - - - - - - - - - - - - - - - - - - - - - - - - - - - - - - - - - - - - - - - - - - - - - - - - - - - - - - - - - - @ @ @ - - - - - - - @ - - - - - - - - - - - -|
|- - - - - - - - - - - - - - - - - - - - - - - - - - - - - - - - - - - - - - - - - - - - - - - - - - - - - - - - - - - - - - - - - - - - - - - - - - - - - - - - - - - - - - - @ - - - - - - - - - - - -|
|- - - - - - - - - - - - - - - - - - - - - - - - - - - - - - - - - - - - - - - - @ - - - - - - - - - - - - - - - - - - - - - - - - - - - - - - - - - - - - - - - - @ @ - - - - @ - - - - - - - - - - - -|
|- - - - - - - - - - - - - - - - - - - - - - - - - - - - - - - - - - - - - - - - @ - - - - - - - - - - - - - @ @ @ - - - - - - - - - - - - - - - - - - - - - - - - @ @ - - - - - - - - - - - - - - @ @ @|
|- - - - - - - - - - - - - - - - - - - - - - - - - - - - - - - - - - - - - - - - @ - - - - - - - - - - - - - - - - - - - - - - - - - - - - - - - - - - - - - - - - - - - - - - - - - - - - - - - - - - -|
|- - - - - - - - - - - - - - - - - - @ @ @ - - - - - - - - - - - - - - - - - - - - - - - - - - - - - - - - - - - - - - - - - - - - - - - - - - - - - - - - - - - - - - - - - - - - - - - - - - - - - - -|
|- - - - - - - - - - - - - - - - - - - - @ @ @ - - - @ @ @ - @ @ @ - - - - - - - - - - - - - - - @ @ - - - - - - - - - - - - - - - - - - - - - - - - - - - - - - - - - - - - - - - - - - - - - - - - - -|
|- - - - - - - - - - - - - - - - @ @ @ - - @ @ - - - - - - - - - - - - - - - - - @ @ @ @ - - - - @ @ - - - - - - - - - - - - - - - - - - - - - - - - - - - - - - - - - - - - - - - - - - - - - - - - - -|
|- - - - - - - - - - - - - - - - - - - - - - - - - - - @ - - - - @ @ - - - - - - - - - - - - @ @ @ - - - - - - - - - - - - - - - @ @ @ - - - - - - - - - - - - - - - - - - - - - - - - - - - - - - - - -|
|- - - - - - - - - - - - - - - - - - - - - - - - - - - @ - - - @ @ @ - - - - - - - - - - - - @ @ - - - - - - - - - - - - - - - - - - - - - - - - - - - - - - - - - - - - - - - - - - - - - - - - - - - -|
|- - - - - - - - - - - - - - - - - - - - - - - - - - - @ - - - @ @ - - - - - - - - - - - - - - - - - - - - - - - - - - - - - - - - - - - - - - - - - - - - - - - - - - - - - - - - - - - - - - - - - - -|
|- - - - - - - - - - - - - @ - - - - - - - - - - - - - - - - - - - - - - - - - - - - - - - - - - - - - @ @ @ - - - - - - - @ @ - - - - - - - - - - - - - - - - - - - - - - - - - - - @ - - - @ - - - - -|
|@ @ - - - - - - @ @ - - - @ - - - - - - - - - - - - - - - - - - - - - - - - - - - - - - - - - - - - - - @ @ - - - - - - - @ @ - - - - - - - - - - - - - - - - - - - - - - - - - - - @ - - - @ - - - - -|
|@ @ - - - @ @ @ @ @ - - - @ @ @ @ @ - - - - - - - - @ @ - - - - - - - - - @ @ - - @ @ - - - - - - - - - @ @ - - - - - - - - - - - - - - - - - - - - - - - - - - - - - - - - - - - - @ - - - @ - - - - -|
|- - - - - - - - - - - - - - @ - - - - - - - - - - - @ @ - - - - - - - - - @ @ - - @ @ - - - - - - - - - - - - - - - - - - - - - - - - - - - - - - - - - - - @ - - - - - - @ @ - - - - - - - - - - - - -|
|- - - - - - - - - - - - - - @ - - - - - - - - - - - - - - - - - - - - - - - - - - - - - - - - - - - - - - - - - - - - - @ @ - - - - - - - - - - - - - - - - @ - - - - - - @ @ - - - - - - - - - - - - -|
|- - - - - - - - - - - - - - @ - - - - - - - - - - - - - - - - - - - - - - - - - - - - - - @ @ @ - - - - - - - - - - - - @ @ - - - @ @ - - - - - - - - - - - @ - - - - - - - @ @ - - - - - - - - - @ - -|
|- - - - - - - - - - - - - - - - - - - - - - - - - - - - - - - - - - - - - - - - - - - - - - - - - - - - - - - - - - - - - - - - - @ @ - - - - - - - - - - - - - - - - - - - - @ - - - - - - - - - @ - -|
|- - - - - - - - - - - - - - - @ @ @ - - - - - - - - - - @ @ - - - - - - - - - - - - - - - - - - - - - - - - - - - - - - - - - - - - - - - - - - - - - - - - - - - - - - - - - @ - @ @ @ - - - - - @ - -|
|- - - - - - - - @ @ - - - - - - - - - - - - - - - - - - @ @ - - - - - - - - - - - - - - - - - - - - - - - - - - - - - - - - - - - - - - - - @ @ - - - - - - - - - - - - - - - - - - - - - - - - - - - -|
|- - - - - - - - @ @ - - - - - - - - - - - - - - - - - - - @ - - - - - - - - - - - - - - - - - - - - - - - - - - - - - - - - - - - - - - - - @ @ - - - - - - - - - - - - - - - - - - - - - - - - - - - -|
|- - - - - - - - - - - @ @ - - - - - - - - - - - - - - - - @ - - - - - - - - - - - - - - - - - - - - - - - - - - - - - - - - - - - - - - - - - - - - - - - - - - - - - - - - - - - - - - @ @ @ - - - - -|
|- - - - - - - - - - - @ @ - - - - - - @ @ @ - - - - - - - @ - - - - - - - - - - - - - - - - - - - - - - - - - - - - - - - - - - - - - - - - - - - - - - - - - @ - - - - - - - - - - - - - - - - - - - -|
|- - - - - - - - - - - @ - - - - - - - - - - - - - - - - - - - - - - - - - - - - - - - - - - - - - - - - - - - - @ - - - - - - - - - - - - - - - - - - - - - - @ - - - - - - - - - - - - - - - - - - - -|
|- - - - - - - - - - - - - - - @ - - - - - - - - - - - - - - - - - - - - - - - - - - - - - - - - - - - - - - - - @ - - - - - - - - - - - - @ - - - - - - - - @ @ @ @ @ - - - - - - - - - - - - - - - - -|
|- @ @ - @ - - - - - - - - - - @ - - - - - - - - - - - - - - - - - - - - - - - - - - - - - - - - - - - - - - - - @ - - - - - - - - - - - - @ - - - - - - - - @ - - @ @ @ @ - - - - - - - - - - - - - - -|
|- @ @ - @ - - - - - - - - - - @ - - - - - - - - - - - - - - - - - - - - - - - - - - - - - - - - - - - - - - - - - - - - - - - - - - - - - @ - - - - - - - - @ - - @ @ - - - - - - - - - - - - - - - - -|
|- - - - @ - - - - - - - - - - - - - - - - - - @ @ @ - - - - - - - - - - - - - - - - - - - - - - - - - - - - - - - - - - - - - - - - - - - - - - - - - - - - - - - - - - - - - - - - - - - - - - @ @ @ -|
|- - - - - - - - - - - - - - - - - - - - - - - - - - - - - - - - - - - - - @ @ - - - - - - - - - - - - - - - - - @ - - - - - - - - - - - - - - - - - - - - - - - - - - - - - - - - - - - - - - - - - - -|
|- - - - - - - - - - - - - - - - - - - - - - - - - - - - - - - - - - - - - @ @ - - - - - - - - - - - - - - - - - @ - - - - - - - - - - - - - - - - - - - - - - - @ @ @ - - - - - - - - - - - - - - - - -|
|- - - - - - - - - - - - - @ - - - - - - - - @ @ - - - - - - - - - - - - - - @ - - - - - - - - - - - - - - - - - @ - - - - - - - - - - - - @ @ - - - - - - - - - - - - - @ @ - - - - - - - - - - - @ - -|
|- - - - - - - - - - - - - @ - - - - - - - - @ @ - - - - - - - - - - - - - - @ - - - - - - - - - - - - - - - - - - - - - @ - - - - - - - - @ @ - - - - - - - - - - - - - @ @ - - - - - - - - - - - @ - -|
|- - - - - - - - - - - - - @ - - - - - - - - - - - - - - - - - - - @ @ - - - @ - - - - - - - - - - - @ @ - - - - - - - - @ - - - - - - - - - - - - - - - - - - - - - - - - - - - - - - - - - - - - @ - -|
|- - - - - - - - - - - - - - - - - - - - - - - - - - - - - - - - - @ @ - - - - - - - @ - - - - - - - @ @ - - - - - - - - @ - - - - - - - - - - - - - - - - - - - - - @ @ @ - - - - - - - - - - - - - - -|
|- - - - - - - - - - - - - - - - - - - - - - - - - @ - - - - - - - - - - - @ - - - - @ - - - - - - - - - - - - - - - - - - - - - @ @ - - - - - - - - - - - - - - - - - - - - - - - - - - - - - - - - - -|
|- - - - - - - - - - - - - - - - - - - - - - - - - @ - - - - - - - - - - - @ @ @ - - @ - - - - - - - - - - - - - - - - - - - - - @ @ - - - - - - - - - - - - - - - - - - - - - - - - - - - - - - - - - -|
|- - - - - - - - - - - - - - - - - - - - - - - - - @ - - - - - - - - - - - @ @ @ - - - - - - - - - - - - - - - - - - - - @ - - - - - - - - - - - - - - - - - - - - - - - - - - - - - - - - - - - - - - -|
|- - - @ @ - - - - - - - - - - - - - - - - - - - - - - - - - - - - - - - - - - - - - - - - - - - - - - - - - - - - - - - @ - - - - - - - - - - - - - - - - - - - - - - - - - - - - - - - - - - - - - - -|
|- - - @ @ - - - - - - - - - - - - - - - - - - - - - - - - - - - - - - - - - - - - - - - - - - - - - - - - - - - - - - - @ @ @ - - - - - - - - - - - - - - - - - - - - - - - - - - - - - - @ - - - - - -|
|- - - - - - - - - - - - - - - - - - - - - - - - - - - - - - - - - - - - - - - - - - - - - - - - - - - - - - - - - - - - - @ @ - - - - - - - - - - - - - - @ - - - - - - - - - - - - - - - @ - - - - - -|
|- - - - - - - - - - - - - - - - @ @ - - - - - - - - - - - - - - - - - - - - - - - - - - - - - - - - - - - - - - - - - - - - - - - - - - - - - - - - - - - @ - - - - - - - - - - - - - - - @ - - - @ @ -|
|- - - - - - - - - - - - - - - - @ @ - - - - - - - - - - - - - - - - - - - - - - - - - - - - @ @ - - - - - - - - - - - - - - - - - - - - - - - - - - - - - @ - - - - - - - - - - - - - - - - - - - @ @ -|
|- - - - - - - - - - - - - - - - - - - - - - - - - - - - - - - @ - - - - - - - - - - - - - - @ @ - - - - - - - - - - - - - - - - - - - - - - - - - - - - - - - - - - - - - - - - - - - - - - - - - - - -|
|- - - - - - - - - - - @ - - - - - - - - - - - - - - - - - - - @ - - - - - - - - - - - - @ @ @ - - - - - - - - - - - - - - - - - - - - - - - - - - - - - - - - - - - - - - - - - - - - - - - - - - - - -|
|- - - - - - - - - - - @ - - - - - - - - - - - - - - - - - - - @ - - - - - - - - - - - - @ @ - - - - - - - - - - - - - @ @ - - - - - - - - - - - - - - - - - - - - - - - - - - - - - - - - - - - - - - -|
|- @ @ - - - - - - - - @ - - - - - - - - - - - - - - - - - - - - - - - - - - - - - - - @ @ @ - - - - - - - - - - - - - @ @ - - - - - - - - - - - - - - - - - - - - - - - - - @ @ @ - - - @ @ @ - - - - -|
|- @ @ - - - - @ @ @ - - - @ - - - - - - - - - - - - - - - - - - - - - - - - - - - - - - - @ - - - - - - - - - @ @ - - @ @ @ - - - - - - - - - - - - - - - - - - - - @ @ @ - - - - - - - - - - - - - - -|
|- - - - - - - - - - - - - @ - - - - - - - - - - - - - - - - - - - - - - - - - - - - - - - @ - - - - - - - - - @ @ - - - - - - - - - - - - - - - - - - - - - - - - - - - @ - - - - - - - - - @ @ @ - - -|
|- - @ @ - - - - - - - - - @ - - - - - @ - - - - - - - - - - - - - - - - - - - - - - - - @ @ - - - - - - - - - - - - - - - - - - - - - - - - - - - - - - - - - - - - - - @ - - - - - - - - - - - - - - -|
|- - @ @ - - - - - - - - - - - - - - - @ - - - - - - - - - - - - - - - - - - - - - - - - @ @ - - - - - - - - - - - - - - @ @ @ - - - - - - - - - - - - - - - - - - - - - @ - - - - - - - - - - - - - - -|
|- - - - - - - @ @ @ - - - - - - - - - @ - @ @ - - - - - - - - - - - - - - - - - - - - - - - - - - - - - - - - - - - - - - - - - - - - - - - - - - - - - - - - - - - - - @ - - - - - - - - - - - - - - -|
|- - - - - - - - - - - - - - - - - - - - - @ @ - - - - - - @ - - - - - - - - @ @ @ - - - - - - - - - @ @ @ - - - - - - - - - - - - - - - - - - - - - - - - - - - - - - - @ - - - - - - - - - @ @ @ @ - -|
|- - - - - - - - - - - - - - - - - - - - - - - - - - - - - @ - - - - - - - - @ - - - - - - - - - - - - - - - - - - - - - - - - - - - - - - - - - - - - - - - - - - - @ @ @ - - - - - - - - - @ @ @ @ - -|
|- - - - - - - - - - - - - - - - - - - - - - - - - - - - - @ - - - - - - - - @ - - - - - - - - - - - - - - - - - - - - - - - - - - - - - - - - - - - - - - - - - - - - - - - - - - - - - - - - - - - - -|
|- - - - - - - - - - - - - - - - - - - - - - - - - - - - - - - @ - - - - - - - - - - - - - - - - - - - - - - - - - @ @ @ - - - - - - - - - - - - - - - - - - - - - - - - - - - - - - - - - - - - - - - -|
|- - - - - - - - - - - - - - - - - - - - - - - - - - - - - - - @ - - - - - - - @ @ @ - - - - - - - - - - - - - - - @ @ - - - - - - - - - - - - - - - - - - - @ @ - - - - - - - - - - - - - - - - - - - -|
|- - - - - - - - - - - - - - - - - - - - - - - - - - - - - - - @ - - - - - - - - - - - - - @ @ @ - - - - - - - - - @ @ - - - - - - - - - - - - - @ @ @ - - - @ @ - - - - - - - - - - - - - - - - - - - -|
|- - - - - - - - - - - - - - - - - - - - - - - - - - - - - - - - - - - - - - - - - - - - - - - - - - - - - - - - - - - - - - - - - - - - - - - - - - - - - - - - - - - - - - - @ - - - - - @ @ @ - - - -|
|- - - - - - - - - - - - - - - - - - - - - - - - - - - - - - - - - - - - - - - - - - - - - - - - - - - - - - - - - - - - - - - - - - - - - - - - - - - - - @ @ - @ @ - - - - - @ - - - - - - - - - - - -|
|- - - - - - - - - - - - - - - - - - - - - - - - - - - - - - - - - - - - - - @ - - - - - - - - - - - - - - - - - - - - - - - @ @ - - - - - - - - - - - - - @ @ - @ @ - - - - - @ - - @ @ - - - - - - - -|
|- - - - - - - - - - - - - - - - - - - - - - - - - - - - - - - - - - - - - - @ - - - - - - - - - - - - - - - - - - - - - - - @ @ - - - - - - - - - - - - - - - - - - - - - - - @ - - @ @ - - - - - - - -|
|- - - - - - - - - - - - - - - - - - - - - - - - - - - - - - - - - - - - - - @ - - - - - - - - - @ @ - - - - - - - - - - - - - - - - - - - - - - - - - - - - - - - @ - - - - - @ - - - - - - - - - - - -|
|- - - - - - - - - - - - - - - - - - - - - - - - - - - - - - - - - - - @ @ - - - - - - - - - - - @ @ - @ @ - - - - - - - - - - - - - - - - - - - - - - - @ - - - - @ - - - - - @ - - - - - - - - - - - -|
|- - - @ @ - - - - - - - - - - - - - - - - - - - - - - - - - - - - - - @ @ - - - - - - - - - - - - - - @ @ - - - - - - - - - - - - - - - - - - - - - - - @ - - - - @ - - - - - @ - - - - - - - - - - - -|
|- @ - @ @ - - - - - - - - - - - - - - - - - - - - - - - - - - - - - - - - - - - - - - - - - - - - - - - - - - - - - - - - - - - - - - - - - - - - - - - @ - - - - - - - - - - - - - - - - - - - - - - -|
|- @ - @ @ - - - - - - - - - - - - - - - - - - - - - - - - - - - - - - - - - - - - - - - - - - - - - - - - - - - - - - - - - - - - - - - - - - - - - - - - - - - - - - - - - - - - - - - - - - - - - - -|
|- @ - @ @ - - - - - - - - - - - - - @ @ - - - - - - - - - - - - - - - - - - - - - - - - - - - - - - - - - - - - - - - - - - - - - - - - - - - - - - - - - - - - - - - - - - - - - - - - - - - - - - - -|
|- - - - - - - - - - - - - - - - - - @ @ - - - - - - - - - - - - - - - - - - - - - - - - @ @ - - - - - - - - - - - - - - - - - - - - - - - - - - - - - - - - - - - - - - - - - - - - - - - - - - - - - -|
