20 20
|@ @ - - - - - - - - @ - @ @ - - - - - -|
|- - - - - - - - - - @ - @ @ - - - - - -|
|- - - - @ @ @ @ - - - - - - - - - - - -|
|- - - - - @ @ @ @ - - - - - - - - @ @ @|
|- - - - - @ @ @ @ - - - - - - - - - - -|
|- - @ - - - - - @ - - - @ @ @ @ @ - - -|
|- - @ - - - - - - - - - - - - @ @ - - -|
|- - @ - - - - - - - - - - - - - - - - -|
|- @ @ - - - - - - - - - - - - - - - - -|
|- @ @ @ @ - - - - - - - - - - - - - - -|
|- - - @ @ - @ @ - - - - - - - - - - - -|
|- - - @ @ - @ @ - - - - - @ - - - - - -|
|- - - @ @ - - - - - - - - @ - - - - - @|
|@ - @ @ @ - - @ @ @ @ - - @ - - - - - @|
|@ - - - @ @ - @ - - - - - - - - @ @ @ @|
|@ - @ @ @ @ - @ - - - - - - - - @ @ @ -|
|- - - - - - - @ - - - - @ - @ @ @ - - -|
|- - - - - - - - - - - - @ - - - @ - - -|
|- - @ @ @ - - - - - - - @ - - - - - - @|
|- - - - - - @ @ @ - @ @ @ - - - - - - @|
