10 10
|- - - - - - - @ @ -|
|- - - - - - - @ @ @|
|- - - @ @ @ - - @ @|
|- - - @ @ @ - - - -|
|- - - @ @ - - - @ @|
|- - - @ @ - - - @ @|
|- - - @ @ - @ @ @ @|
|- - - - - - - - - @|
|- @ @ @ @ @ @ - - @|
|- - - @ @ @ - - - @|
