10 10
|- - - - - - - - - -|
|- - - - - - - - - -|
|- - - - - - - - - -|
|- - - - - - - - - -|
|- - - - - @ @ @ - -|
|- - - - - @ @ - - -|
|- - - - - - - - - -|
|- - - - - - - - - -|
|- - - - - - - - - -|
|- - - - - - - - - -|
