30 30
|- - - - - - - - - - - - - @ @ @ - - - - - - - @ @ @ - - - -|
|- - - - - - @ - - - - - - - - @ @ @ - - - - - - - - - - - -|
|- - - - @ @ @ - - - - - @ - - - @ @ - - - - - - - - - - - -|
|- - @ @ @ @ @ @ - - - - @ - - - - - - - @ @ @ - - - - - - @|
|- - - - - - - @ - @ - - @ - - - - - - - @ @ @ - - - - - - @|
|- - - - - - - @ - @ - - - - - - - - - - - @ @ @ - - - - - -|
|- - - - - - - - - @ - - - - @ @ @ - - - - - - @ @ - - - - -|
|- - - - - - - - - - - - - @ @ - - - - - - - - @ @ @ @ @ - -|
|- - - - - - - - - - - - - @ @ - - - - - - - - - - @ @ @ - -|
|- - - - - - - - - - - - - @ @ - - - - - - - - @ - - @ @ - -|
|- - - - - - - - - - - - - - - - - - - - - - - @ - - @ @ - -|
|- - - - - - - - - - - - - - - - - - - - - - - @ - - - - - -|
|- - - - @ @ @ - - @ @ @ - - - - - - - - @ - - - - - - - - -|
|- - - - @ @ @ - - - - - - - - - - - - - @ - - - - - - - - -|
|- @ @ - @ - - - - - - - - - - - - - - - @ - - - - - - - - -|
|@ @ @ - @ @ @ @ - - - - - - - - - - - - - - - - - - - - - -|
|@ @ - - @ - - - - - - - - @ @ @ - - - - - - - - - - - - - -|
|- - - - - - - - - - - - - - - - - - - - - - - - - - - - - -|
|- - - @ - - - - - - - - - - - - - - - - @ - - - - - - - - -|
|- - - @ - - @ @ @ - - - - - - - @ @ @ - @ - - - - - - - - -|
|- - - @ - - - - @ - - - - - - - - @ @ - @ - - - - - @ @ @ @|
|@ - - - - - - - @ - - - - - - - - @ @ - - - - - - - - - @ -|
|@ - - - - - - - - - - - @ @ @ - - - @ @ @ - - - - - - - @ -|
|@ - - - - - - - - - @ @ @ - - - - - - - - - - - - - - - @ -|
|@ @ @ - - - - - - - @ @ @ - - - - - - - - - - - - - - - - -|
|- @ @ - - - - - - - @ - - - - - - - - - - - - - - - - @ - -|
|- - - - - - - - - - - - - - - - - - - - - - - - - - - @ - -|
|- - @ @ - - - - - - - - - - - - - - @ @ @ - - - - - @ @ @ -|
|- - @ @ @ - - - - - - - - - - - - - - - - - @ @ @ - - - - -|
|- - - - @ - - - - - - - - - - @ @ - - - - - - - - - - @ @ -|
