100 20
|- - - - - - - - - - - - - - - - - - - - - - - - - - - - - - - - - - - - - - - - - - - - - - - - - - - - - - - - - - - - - - - - - - - - - - - - - - - - - - - - - - - - - - - - - - - - - - - - - - - -|
|- - - - - - - - - - - - - - - - - - - - - - - - - - - - - - - - - - - - - - - - - - - - - - - - - - - - - - - - - - - - - - - - - - - - @ @ @ - - - - - - - - - - - - - - - - - - - - - - - - - - - - -|
|- - - - - - - - - - - - - - - - - - - - - - - - - - - - - - - - - - - - - - - - - - - - - - - - - - - - - - - - - - - - - - - - - - - - - - - - - - - - - - - - - - - - - - - - - - - @ - - - - - - - -|
|- - - - - - - - - - - - - - - - - - - - - - - - - - - - - - - @ @ @ - - - - - - - - - - - - - - - - - - - - - - - - - - - - - - - - - - - - - - - - - @ - @ @ - - - - - - - - - - - - @ - - - - - - - -|
|- - - - - - - - - - - - - - - - - - - - - - - - - - - - - - - - - - - - - - - - - - - - - - - - - - - - - - @ @ @ - - @ @ @ - - - - - - - - - - - - - @ - @ @ - - - - - - @ @ @ - - - @ - - - - - - - -|
|- - - - - - - - - - - - - @ - - - - - - - - - - - - - - - - - - - - - - - - - - - - - - - - - - - - - - - - - - - - - - - - - - - - - - - - - - - - - @ - - - - - - - - - - - - - - - - - - - - - - - -|
|- - - - - - - - - - - - - @ - - - - - - - - - - - - - - - - - - - - - - - - - - - - - - - - - - - - - - - - - - - - - - - - - - - - - - - - - - - - - - - - - - - - - - - - - - - - - - - - - - - - - -|
|- - - - - - - - - - - - - @ - - - - - - - - - - - - - - - - - - - - - - - - - - - - - - - - - - - - - - - - - - - - - - - - - - - - - - - - - - - - - - - - - - - - - - - - - - - - - - - - - - - @ @ @|
|- - - - - - - - - - - - - - - - - - - - - - - - - - - - - - - - - - - @ - - - - - - - - - - - - - - - - - - - - - - - - - - - - - - - - - - - - - - - - - - - - - - - - - - - - - - - - - - - - - - - -|
|- - - - - - - - - - - - - - - - - - - - - - - - - - - - - - - - - - - @ - - - - - - - - - - - - - - - - - - - - - - - - - - - - - - - - - - - - - - - - - - - - - - - - - - - - - - - - - - - - - - - -|
|- - - - - - - - - - - - - - - - - - - - - - - - - @ @ @ - - - - - - - @ - - - - - - - - - - - - - - - - - - - - - - - - - - - - - - - - - - - - - - - - - - - - - - - - - - - - - - - - - - - - - - - -|
|- - - - - - - - - - - - - - - - - - - - - - - - - - - - - - - - - - - - - - - - @ - - - - - @ @ @ - - - - - - - - - - - - - - - @ - - - - - - - - - - - - - @ @ @ - - - - - - - - - - - - - - - - - - -|
|- - - - - - - - - - - - - - - - - - - - - - - - - - - - - - - - - - - - - - - - @ - - - - - - - - - - - - - - - - - - - - - - - @ - - - - - - - - - - - - @ @ @ - - - - - - - - - - - - - - - - - - - -|
|- - - - - - - - - - - - - - - - - - - - - - - - - - @ @ - - - - - - - - - - - - @ - - - - - - - - - - - - - - - - - - - - - - - @ - - - - - - - - - - - - - - - - - @ @ @ - - - - - - - - - - - - - - -|
|- - - - - - - - - - - - - - - - - - - - - - @ @ @ @ @ @ - - - - - - @ - - - - - - - - - - - - - - - - - - - - - - - - - - - - - - - - - - - - - - - - - - - - - - - - - - - - - - - - - - - - - - - - -|
|- - - @ - - - - - - - - - - - - - - - - - - - - - @ @ - - - - - - - @ - - - - - - - - - - - - - - - - @ @ @ @ - - - - - - - - - - - - - - - - - - - - - - - - - - - - - - - - - - - @ @ @ @ @ - - - - -|
|- - - @ - - @ - - - - - - - - - - - - - - - - - - @ @ - - - - - - - @ - - - - - - - - - - - - - - - - - - @ @ @ - - - - - - - - - - - - - - - - - - - - - - - @ @ - - - - - - - - @ @ - - - - - - - - -|
|- - - @ - - @ - - - - - - - - - - - - - - - - - - - - - - - - - - - - - - - - - - - - - - - - - - - - - - - - @ - - - - - - - - - - - - - - - - - - - - - - - @ @ - - - - @ @ - - @ - - - - - - - - - -|
|- - - - - - @ - - - - - - - @ @ @ - - - - - - - - - - - - - - - - - - - - - - - - - - - - - - - - - - - - - - @ - - - - - - - - - - - - - - - - - - - - - - - - - - - - - @ @ - - @ - - - - - - - - - -|
|- - - - - - - - - - - - - - - - - - - - - - - - - - - - - - - - - - - - - - - - - - - - - - - - - - - - - - - - - - - - - - - - - - - - - - - - - - - - - - - - - - - - - - - - - - - - - - - - - - - -|
