100 20
|- @ - @ - - @ - - - - - - - - - - - @ - @ @ @ @ - - - - - - - @ @ @ - - - - @ - - @ @ @ - @ @ - @ @ @ - - - - - - @ - - - @ @ - - - - - - - - @ @ @ @ - - - - @ @ - - - - - - - @ @ - - @ @ @ - - - - -|
|@ @ - @ - - @ - @ @ - - - - @ @ @ - @ - @ @ @ @ - - - @ - - - @ @ @ - - - - @ - - @ @ @ - @ @ @ @ - - - - @ @ @ - @ @ @ @ @ @ - - - - - - @ @ @ - - - - - - - @ @ - @ - - - @ @ @ @ @ @ @ @ @ @ @ @ @ @|
|@ - - @ - - - - @ @ @ @ @ @ @ - - - @ - @ @ @ - - - - @ - - @ @ @ - - - - - @ - - - - - - @ @ @ @ - - - - - - - - - @ @ @ - - - - - - - - @ @ @ - - @ @ @ - - - @ @ @ - - - @ @ - - @ @ - - - - - @ @ @|
|@ @ @ @ - - - @ @ @ @ @ - - - - - - @ - - - - - - - - @ - - @ - - - - - - - @ - - @ @ - - @ @ @ @ - - - - - - - - - - - @ @ @ - - @ @ @ - @ @ - - - - - - - @ - - @ @ - - - @ @ - @ @ @ @ @ - @ @ @ @ @|
|@ @ @ @ @ - - @ @ @ @ - - @ @ - - - @ @ @ - - - @ @ @ @ - @ @ - - - - - - - - - - @ @ - - @ - @ - - - - - @ - - - - - - @ @ @ - - - - - - @ @ @ - - - - - - @ - - @ @ @ - @ @ @ - @ - - @ - - @ - @ @ @|
|- - - - @ - - - - @ @ - - @ @ - - - - @ @ @ @ - @ - @ @ @ @ @ @ @ - - - - - - - - @ @ - - @ @ @ @ - - - - @ - @ - - - @ @ @ @ @ - - @ - - @ @ @ - - - - - - @ @ @ @ - @ - @ - @ - @ - @ @ @ @ @ @ @ - -|
|@ - - @ @ - - @ @ @ - - - - @ - - - - - - @ @ @ @ - @ @ - @ - - - - - - - - @ @ @ @ - - - - - - @ @ @ @ @ @ - @ - - - @ @ @ @ @ @ - @ - - @ - @ - - - - @ - - @ @ - - @ - @ @ @ - @ @ @ @ @ @ @ @ @ - -|
|@ - - @ @ @ - @ @ @ @ @ - - @ - - - - - - - @ @ @ - @ @ - - - - @ - - - - - - - - @ - - @ - @ @ @ - - @ @ @ - @ - - - @ - - @ - @ @ @ @ @ @ - @ - - - - @ - - - @ @ @ @ - @ @ @ - - @ @ - @ @ - - - - -|
|@ - - @ - - - @ @ @ - @ @ - @ - @ @ @ @ @ @ @ - - - - - - - - - @ - - - - - - @ @ @ - - @ - @ @ @ - - @ - - - - - - @ @ - @ @ @ @ @ @ - - - - @ - - - @ @ - - - @ @ @ - - @ @ @ @ - @ @ - @ @ @ @ @ - -|
|- - - - - - @ @ - @ @ @ @ - @ - - - - @ - - - - - @ - - - - - @ @ - - - - @ - @ @ @ - - @ - - - @ - - @ - @ @ @ - - @ @ - - - - - @ @ - - @ - @ @ @ - @ @ @ - - @ @ @ @ @ @ - @ @ @ @ @ @ @ - - @ @ @ @|
|- @ @ @ - @ @ @ - - @ @ - - - - - - - @ - - - - - @ @ @ - - - @ @ @ @ - - @ - - - - - - @ @ @ @ @ @ @ @ @ @ - - - - - @ @ - - - - - - - - @ - @ @ @ - - @ @ - - @ - - @ @ @ - - - - - - - - - - @ @ @ @|
|- @ @ @ @ @ @ @ - - @ - - - - - - - @ @ - - - - - @ - - - - - - - @ @ @ @ @ - @ @ @ - - @ @ @ @ @ - - @ @ - - @ - @ @ @ @ - - - - - - - - @ - - - - - - - - - - - - - - - @ - - @ @ - - @ @ - - @ @ - @|
|- @ @ @ - @ @ @ - - @ - - - - - - - @ @ - - - - - - - @ @ @ @ @ - - @ @ - - - @ @ @ - - - @ - - @ @ - @ @ @ - @ - @ @ - @ - - - - - - - - @ @ @ - - - - - - - - - - @ @ @ @ @ - @ @ - - @ @ - - @ @ - -|
|- - @ @ - @ - - - - - - - - @ @ - - @ - - - @ @ @ - - - - - @ @ @ - @ @ @ @ @ @ @ @ - - - @ - - - @ @ @ - @ @ @ - - - - - - - - - - @ - - @ @ @ - - - @ @ @ - - - - @ @ @ - - - - - - - - @ @ @ @ @ - -|
|- - - - - - - - @ @ - - - - @ @ - @ @ @ - - - - - - - - - - - - - - - - - - - - @ @ @ @ - @ @ @ @ @ @ @ @ @ @ - - - - - - - - - @ @ @ @ @ @ - - - - - - - - - - - - @ @ @ @ @ - - - - - - - @ - - - - -|
|- - - @ @ @ - - @ @ - - @ - @ @ - - - @ @ @ @ @ @ - @ @ @ @ - - - @ - - - - @ @ @ - - @ @ @ - - @ @ @ @ - - @ @ @ @ - - @ - - - @ @ @ @ @ @ - - - @ - - - - - - @ @ @ @ - - - - - - - - - - @ - - - @ @|
|- - - @ @ @ - - - @ @ @ @ - - @ @ - @ @ @ - @ @ @ @ @ - - - - - @ @ - - - - @ @ @ - @ @ @ @ - - @ - - - - - - - - - - - @ - - - @ @ @ @ @ @ - - - @ @ - - - - - - - @ @ - - - - @ - - - - - - - - - - -|
|@ - - - - @ - - - @ @ @ @ - - @ @ - @ - - - @ @ @ - @ @ @ @ - @ @ @ @ - - - @ @ @ @ @ - - - - - @ - @ @ - - - - - - - - @ - - - - - - @ @ - - - - @ @ - - @ @ @ - - @ @ @ - - - @ - - - - - - - - @ @ -|
|@ - - - - @ - @ @ @ @ @ @ - - - @ @ @ - - - @ - - - - - - - - @ @ @ @ - - - - - @ @ @ - @ @ @ @ @ - @ @ - @ @ - - - - - @ - @ @ @ @ - @ @ - - - - - @ - - - @ @ @ - @ @ @ - - - @ - - - - - - - @ @ @ -|
|@ - - - - @ @ @ - - - - @ - - - @ @ @ - @ @ @ @ @ @ - - - - - @ - - - - - - - @ @ @ - - @ @ - - - - - - - @ @ - - @ @ @ @ - @ @ - - - - - - - - - - @ @ - - @ - @ - @ @ @ @ @ @ @ - - - - @ @ @ @ - @ @|
