10 10
|- - - - - - - - - -|
|- - - - - - - - - -|
|- - - - - - - - - -|
|- - - @ @ - - - - -|
|- - - @ @ - - - - -|
|- - - - - - - - @ -|
|- - - - - - - - @ -|
|- - - - - - - - @ -|
|- - - - - - - - - -|
|- - - - - - - - - -|
