100 100
|- - - - @ - - - - @ - - - - - - @ @ - @ @ @ @ @ @ @ @ @ @ - - - - - - @ - - - - - - @ - - - - - - @ - - @ @ @ - - - - - - - - @ @ - - - - - - - @ @ - - - @ @ @ - - - - - - - - - - - - - - - - - - @ -|
|- - @ @ @ - - @ - @ - - - - - - @ @ - - - - - - - @ - - - - - - - - - @ - - - - @ @ @ - - - - - - @ - - @ @ @ - - - - - - - - @ @ - - - - - - - @ @ - - - - - - - - - - - - - - - - - - - - - - - - @ -|
|- @ @ - @ - - @ - @ @ @ @ @ - - - - - - - - - - - @ - - - - - - - - - @ @ @ - - - - @ - - - - - - - - - - @ @ - - - - - - - - - - - - - - - - - - - - - - - - - - - @ - - - - - - - - - - - - - - - @ @|
|@ @ - - - - - @ - @ @ - - - - - - - - - - - - - - - - - - - - - @ @ - - @ @ - - - - @ - - - - - - - - - - @ @ - - - - - - - @ @ @ @ @ @ - - - - - @ - - @ - - - - - @ @ @ - - - - - - - - @ - - - - - @|
|@ @ - - - - - - - - @ - - - - - - - - - - - - - - - - - - - - - @ @ - - - @ @ @ - @ @ - - - - - - - - - - - @ - - - - - - - - - - - - - - - - - - @ - - @ - - - - - @ @ @ - - - - - - - @ @ - - - - - @|
|@ - - - - - - - - - @ - - - - - - - - - - - - - - - - - - - - - - - - @ @ @ @ - - @ @ - - - - - - - - - - - @ - - - - - - - - - - - - - - - - - - @ - - @ @ @ - - - - @ @ @ - - - - - - @ @ @ - - - - -|
|- - - - - - - - - - @ - - - - - - - - - - - - - - - - - - - - - - @ @ @ - - - - - - - - - - - - - - - - - - @ - - - - - - - - - - - - - @ @ @ - - @ @ - - @ @ - - - - - - - - - @ @ - - - - @ - - @ @ -|
|@ @ - - - - - - - - - - - - - - - - - - - - - - - - - - @ - - - - - - - - - - - - - - - - - - - - - - - - - - - - - - - - - @ @ - - - - - - - - - - @ - - - - - - - - - - - - - @ @ - - - - @ - - @ @ -|
|@ @ - - - - - - - - - - - - - - - - - - - - - - - - - - @ - - - - - @ @ - - - - - - - - - - - - - - - - @ - - - - - - - - - @ @ - - - - - - - @ @ @ @ - - - - @ @ @ - @ @ @ - - - - - - - - @ - - - - -|
|- - - - - - - - - - - - - - - - - - - - - - - - - - - - @ - - - - @ @ @ - - @ @ - - - - - @ - - - - - - @ - - - - - - - - - - - - - - - @ @ - - - - - - - - - - - - - - - - - - - - - - - - - - - - - -|
|@ @ @ - - - - @ - - - - - - - - @ @ @ @ - - - - - - - @ @ @ - - @ @ - - - - @ @ @ @ - - - @ - - - - - - @ - - - - - - - - - - - - - - @ @ @ - - - - - - - - - - - - - - - - - - - - - - - - - @ @ @ - -|
|@ @ - - - - - @ - - - - - - - @ @ - - - - - @ @ - - @ @ @ - - - @ @ - - - - - - @ @ - - @ @ - - - - - - - - - - - - - - - - - - - - - @ - - - - - - - - - - - @ @ - - - - - - - - - - - - - - - - - - -|
|- - - - - - - @ - - - - - - - @ @ - - - - - @ @ - - @ - @ - - - @ @ @ - - - - - - - - - @ - - - - - - - - - - - - - - - - - - - - - - @ - - - - - - - @ @ @ - @ @ - - - @ - - - - - - - - - - - - - - -|
|- - - - - - - - - - - - - - - - - - - - - - - - - - @ - @ - - - - @ @ @ - - - - - - - - @ - - @ @ - - - - - - - - - - - - - - - - - - @ - - - - - - - - - - - - - - - - @ - @ @ - - - - - - - - - - - -|
|- - - - - - - - - - - - - - - - - - - - - - - - - - - - @ - @ - - @ @ @ - - - - - - - - - - - @ @ @ - - - - - - - - - - - - - - - - - - - @ - - - @ @ - - @ - - - - @ @ @ @ @ @ - - - - - - - - - - - -|
|- - - - - - - - - - - - - - - - - - - - - - - - - - - - - - @ - - - - - - - - @ @ @ - - - - - - - @ - - - - - @ @ @ - - - - - - - - - - - @ @ @ - @ @ - - @ - - - - @ @ - - - - - - - - - - - - - - - -|
|- @ @ - - - - - @ @ @ - - - - - - - - - - - - - - - - - - - @ - - @ @ - - - @ @ @ - - - - - - - @ @ - - - - - - - - - @ @ @ - - - - @ @ - @ @ @ - - - - - @ - - - - - - - - - - - - - @ - - - @ - - - -|
|- @ @ - - - - - @ @ @ - - - - - - - @ @ - - - - - - - - - - - - - @ @ @ - - - - - - - - - - - - @ - - - - - - - - - - - @ - - - - - @ @ - - @ - - - - - - - - - - - - - - - - - - - - @ - - - @ - - - -|
|- - - - - @ @ - - - - - - - - - - - @ @ - - - - - - - @ @ - - - @ @ @ - - - - - - - - - - - - @ @ @ - - - - - - @ @ @ @ @ - - - - - @ @ @ - @ - - - - - - - - - - - @ @ - - - - - - - @ - - - @ - - - -|
|- - - - @ @ @ - - - - - - - - - @ @ @ @ - - - - - - - @ @ - - - - - - - - - - - - - - - - @ @ @ - @ - - - - - - - - @ @ - - @ - - - - - - - @ - - - - - - - - - - - @ @ - @ @ @ - - - - - - - - - - - -|
|- - - - - - @ @ @ @ - - - - - - @ @ - @ - - - - - - - - - - @ @ - - - - - @ @ @ - - - - - @ @ @ - @ - - - - - - - - - - - - @ - - - - - - - - - - - - - - - - - @ @ @ - - - - - - - - - - - - - - - - -|
|- - @ - - - - @ @ @ - - - - - - - @ @ @ - - - - - - @ - - - @ @ - - - - - - - - - - - - - - - - - - - - - - - - - - - - - - @ - - - - - - - - - - - - - - - - - - - - - - - - - - - - - - - - - - @ @ @|
|- - @ - - - - - - - - - - - - - - @ @ - - - - @ - - @ - - - - - - - - - - - - - - @ - - - - - - - - - - - - @ @ @ - - - - - - - @ @ @ @ @ @ - - - - - - - - - - - - - - - - - - - - - - - - - - - @ @ @|
|- - @ - - - - - - - - - - - - - - - - - - - - @ - - @ - - - - - - - - - - - - - - @ - - - - - - - - - - - - - - - - - - - - - - - - - @ @ @ - - - - - - - - - - - - - - - - - - - - - - - - - - - @ @ @|
|- - - - - - - - - - - - - - - - - - - - - - - @ - - - - - - - - - - - - - - - - - @ - - - - - - - - - - - - - - - - - - - - - - - - - @ - - - - - - - - - - @ @ @ @ - - - - - - - - - - - - - - - - - -|
|- - - - - - - - - - - - - @ @ @ - - - - - - - - - - - - - - @ @ @ - - - - - - - - - - - - - - - - - - - - - - - - - - - - - - - - - - @ @ @ - - - - - - - - - @ @ @ - - - - - - - - - - - - - - - - - -|
|- - - - - - @ @ @ - - - - @ @ @ - - - @ @ - - - - - - - - - - - - - - - - - - - - - - - - - - - - - - - - - - @ @ @ @ @ - - - - - @ @ @ - - - - - - - - - - - @ @ @ - - - - - @ - - - - - - - - - - - -|
|- - - - - - - - - - - - - @ - - - - - @ @ - - - - - - - - - - - @ @ @ - - - - - - - - - - - - - - - - - - - - @ @ - - @ - - - - - @ @ - - - @ @ - - - - - - - - - - - - - - - @ - - - - - - - - - - - -|
|- - - - @ @ @ - - - - - - - - - - - - - - - - - - - - - - - - - - - - - - - - - - - - - - - - - - - - - - - - - - - - @ - @ - - - - - - - - @ @ - - - - - - - - - - - - - - - @ - - - - - - - - - - - -|
|- - - - - - - - - @ @ - - - - - - - - - - - - - - - @ @ - @ @ - @ - - - - - @ - - - @ @ @ - - - - - - - - - - - - - - @ - @ - - - - - - - - - - - @ @ @ - - - - - - - - - - - - - - - - - - - @ @ - - -|
|- - - - - - - - - @ @ - - - - - - - - @ - - - - - - @ @ - @ @ - @ - - - - - @ - - - - - - - - - - - - - - - - - - - - - - @ - - - @ - - - - - - - - - - - - - - - - - - - - - - - - @ - - - - @ @ - - -|
|- - - - - - - - - - - - - - @ @ @ - - @ - - - - - - - - - - - - @ - - - - - @ - - - - - - - - - - - - - - - - @ @ - - - - @ - - - @ @ @ @ - - - - - - - - - - - - - - - - - - - - - @ - - - - - - - - -|
|- - - - - @ @ @ - - - - - - - - - - - @ - - - - - @ - - - - - - - - - - - - - - - - - - - @ @ - - - - @ @ - - @ @ - @ @ - @ - - - @ @ - - - - - - - - - - - - - - - - - - - - - @ @ @ - - - - - - - - -|
|@ @ - - - @ @ @ @ @ @ @ @ - - - - - - - - - - - - @ - - - - - - - - - @ @ - - - - - - - - @ @ - - @ - @ @ - - - - - @ @ - @ @ - - - @ - - - - - - - - - - - - - - @ @ @ - - - - @ @ - - - - - - - - - -|
|@ @ - - - @ @ @ @ @ - - - - - - - - - - - - - - - @ - - - - @ @ - - @ @ @ @ - - - @ - - - @ @ - - @ - - - - - - - - - - - - @ @ - @ @ - - - - - - - - - - - - - - - - @ @ @ - @ @ @ @ @ - - - - - - - -|
|- - - - @ @ @ @ - @ - - - - - - - - @ @ - - - - - @ @ @ - - @ @ - - - @ - - - - - @ - - - - - - - @ - @ - - - @ - - @ - - - @ @ - @ @ - - - - - - - - - - - - - @ - - - - - - @ - - - @ - - - - - - @ @|
|- - - - @ - - - - - - - - - - - - - @ @ - - - - - - - @ - - - - - - - @ - - - - - @ - @ @ @ - - - - - @ - @ @ @ @ - @ @ - - - - - @ @ - - - - - - - - - - - - - @ @ @ @ @ - @ @ - - - @ - - - - - - - -|
|- - - - @ - - - @ @ - - - - - - - - - - - - - - - - @ @ - - - - - - - @ - - - @ - - - - - - - - - - - @ - @ @ @ @ - @ @ - @ @ @ - - - - - - - - - - - - - - - @ @ @ - - - - @ @ - - - @ - - - - - - - @|
|- - - - - - - - @ @ - - - - - - - - - - - @ - - - @ @ - - - - - - - - - - - - @ - - - - - - - @ @ @ - @ - - - - @ - - @ - - - - - - - - - - - - - - - - - - - - - - - - - - - @ - - - - - - - - - - - @|
|- - - - - - - - @ - - - - - - - - - - - - @ - - - @ @ @ @ - - - - - - - - - - @ - - - - @ @ - - - - - @ - @ @ @ @ - - @ @ @ @ - - - - - - - - - - - - - - - @ @ @ - - - - - @ @ - - - - - - - - - - @ @|
|- - - - - - - - - - - - - - - - - - - - @ @ - - - - - @ @ - - - - - - - - - - @ @ @ @ - @ @ - - - - - - - - - - - - - - - - @ - - - - - - @ @ - - - - @ @ @ @ - - - - - - - @ - - - - - - - - - - - @ @|
|- - - - - - - - - - - - - - - @ @ @ @ - @ @ @ - - @ - - - - - @ @ @ - - - - - - - - @ @ @ - - - - - - - - - - - - - - @ @ - @ @ @ @ @ - - @ @ - - - - @ - @ @ - - - @ @ @ - @ - - - - - - - - - - - - -|
|@ @ @ - - - - - - @ @ @ - - - - - @ @ - - - @ @ @ @ - - - - - @ @ @ - - - - - - - - @ @ @ - - - - - - - - - - - - - - @ @ - - @ @ @ - - - - - - - - - @ - @ @ @ - - - @ @ @ @ - - @ @ @ @ - - - - - - -|
|- - - - - - - - - - - - - - - - - @ @ - - - @ @ @ @ - - - - - - - - - - - - - - - - - - - - - - - - - - - - - - - - - - - - - @ - @ - - - - - @ - - - - - - @ @ - - @ @ - - @ - - - - - @ - - @ @ - - -|
|- - - - @ - - @ @ @ @ @ - - - - - - - - - - - - - - - - - - - - - - - - - - - @ - - - - - - - - - - - @ @ - - - - - - - - - - @ @ @ - - - - - @ - - - - - @ @ @ - - @ @ - - @ - - - - - @ - - @ @ - - -|
|- - - - @ - - - - - - @ @ - @ - - - @ @ @ - - @ @ - - - - - - - - - - - - - - @ - - - - - - - - - - - @ @ - - - - - - - - - - @ @ @ - - - - - @ - - - @ - - - - - - @ @ - - - - - - @ @ @ - - - - - - -|
|@ @ - - @ - - - - - - @ @ - @ - - - - - - - - @ @ - - @ @ @ - - - - - - - - - @ - - - - - - @ @ - - - - - - - - - - - - - @ @ @ - - - - - - - - - - - @ - - - - @ @ @ @ @ - @ - - - - - - - @ - - - - -|
|- - - - @ @ @ - - - - - - - @ - - - - - - - - @ @ @ @ @ @ @ - - - - - - - - - - - - - - - - @ @ - - @ @ - - - - - - - - - - - - - - - - - - - - - - - @ - - - - @ @ @ - @ - @ - @ @ - - - - @ - - - - -|
|- - - - @ - - - - - @ - - - - - - - - - @ - - @ @ - - - - - - - - - - - - - - - - @ @ - - - @ @ @ - @ @ - - - - - - - @ @ - - - - - - - - @ @ @ - - - - - - - @ @ @ @ - @ - @ - @ @ @ - - - @ @ @ - - -|
|- - - - - - - - - @ @ - - - - - - - - - @ - - - - - - - - - - - - - - @ - - - - - @ @ - - - @ @ - - - - - - - - - - - @ @ - - - - - - - - - @ @ - - - - - - - - - - - - - - - - - - @ - - - - - @ - - -|
|@ - - - - - - - - @ @ - - - - - - - - - @ - - - - - - - - - - - @ @ - @ - - - - - - @ @ - @ @ @ - - - - - - - - - - - - @ @ @ - - - - - - - @ @ - - - - - - - - - - - - @ @ - - - - @ - - - - - @ - - -|
|@ - - - - - - - - @ @ - - - - @ @ - - - @ - - - - - - @ @ @ @ - @ @ @ @ - - - - - - - @ - @ - - - - - - - - - - - - - - - @ @ @ - - - - - - - - - - - - - - - - - - @ @ @ @ @ @ @ @ @ - - @ @ @ @ @ - -|
|@ - - - - - - - - - @ @ @ - - @ @ @ - - @ - @ @ - - - @ @ @ @ - - - @ @ @ @ - - - - @ @ - @ - - - - - - - - - - - - - - - - - - - - - - - - - - - @ @ @ - - - - @ @ @ @ - - @ @ - @ @ @ @ @ @ @ - - - -|
|- - - - - - - - - - - - - - - @ @ @ - - - - @ @ - - - - @ @ - - - - @ - - - - - - - @ - - - - - - - - - - - - - - - - @ - - @ - - - - - - - - - @ @ @ @ @ @ @ - @ @ - - - - @ @ - - - - @ @ @ @ - - - -|
|@ - - - - @ @ @ - - - - - - - @ - - - - - - - - - @ - @ @ @ - - - - - - - - - - - - @ - - - @ @ @ @ @ - - - - - - - - @ - - @ - - - - - - - - - - - - - - - @ @ @ @ - - - - - - - - - - - - - - - - - -|
|@ - - - - - - - - - - - - - - @ - - - - - - - - - @ @ @ - - - - - - - - - - - - - - - - @ @ @ @ @ @ - - - - - - - - - @ - - @ - - - - @ @ @ @ - - - - @ @ @ @ @ - @ @ - - - - - - - - - - - - - - - - -|
|@ - - - - - - - - - - - @ @ - @ - - - - - @ @ @ - @ @ @ - - - - @ - - - - - - - - - - - - @ - - @ @ - - - - - - - - - - - - - - - - - - - @ @ - - - - - - - - - - @ @ @ - - @ @ - - - - - @ - - - - - -|
|- - - - - - - - - - - - @ @ - - - - - - - - - - - - - - - - - - @ - - - - - @ @ @ - - - - @ - - - - - - - @ - - - - - - - - @ - - @ @ @ - - - - - - - - - - - - - - - @ @ - @ @ - - - - - @ - - - - - -|
|- - - - - - - - - - - - - - - - - - - - @ @ @ @ - - - @ - - - @ @ - - - @ @ @ - - - - - - @ @ @ @ - - - - @ - - - @ @ - - - @ - - - - - - - - - - - - - - - - - - - - @ @ - - - - - - - - @ - - - - - -|
|- - @ @ @ - - - - - - - - - @ @ - - - - - - - @ - - - @ - @ @ @ - - - - - @ - - - - - - - - - - - - - - - @ @ @ - @ @ - - - @ - - - - - - - - - - - - - - - - - - - - - - - - - @ - - - - - - - - - - -|
|- - - - - - - - - - - - - - @ @ - - - - - @ - @ - - - @ - - - - - - - - - @ - @ @ @ @ @ - - - - - - - - - - - - - - - - @ @ @ - - - - - - - - - - - - - - - - - - - - - - - - - @ - - - - - - - - @ @ -|
|- - - - - @ @ - - - - - - - - - - - - - - @ - - - - - - - - - - - - - - - - - @ @ - - - - @ - - @ @ @ - @ - - - - - - - - - @ @ - - - - - - - @ @ - - - @ - - - - - - - - - - - @ - - - - - - - - @ @ -|
|- - - - @ @ @ @ - - @ - - - - - - - - - - @ - - @ - - - - - - - - - - - - - - - @ @ - - - @ - - - - - - @ - - - - - - - - - @ @ @ - - - - @ @ @ @ - - - @ - @ @ @ - - - - - - - - - - @ @ - - - - - @ -|
|- - - @ @ - - - - - @ - - - @ - - - @ @ - - - - @ - - - - - - - - - - - - - - - @ @ - - - @ - - - @ @ - @ - - - - - - - @ - - - @ @ @ @ - @ @ @ @ - - - @ - - - - - - - - @ - - - - - @ @ - - - - @ @ -|
|- - - @ @ - - - - - @ - - - @ - - - @ @ - - - - @ - - - - - - - - - - - - - - - - @ @ - - - - - @ @ @ - - - - @ - @ @ @ @ - @ @ @ - - - - @ - - - - - - - - - - - - @ @ - @ - - - - - - @ - - - - @ @ -|
|- - - - - - - @ @ - - - - - @ - - @ @ - - - - - - - - - - - - - - - - - - - - - - - @ - - - - - @ @ - - - - - @ - - @ @ @ - - - @ - - - - - - - - - - - - - - - - - @ @ - @ - - - - - - @ - - - - - @ -|
|- - - - - - - @ @ - - - - - @ @ @ @ @ - - - - - - - - - - @ @ @ - - - - - - - - @ - @ @ - - - - - @ @ - - @ @ @ @ @ @ - - - - - @ @ - - - - - - - - - - - - - - - - - - - @ - - - - - @ @ @ - - - - @ -|
|- - @ @ - - - - - - - - - - @ @ @ - - - - - - - - - - - - - - - - - - @ - - - - @ - - @ @ - - - - - @ - - @ @ @ @ @ @ - - - - - @ @ - - - - - - - - - - - - - - - - - - - @ - - @ - - - - - - - - - @ -|
|- - @ @ - - - - - - - - - - - - @ - - @ @ @ - - @ @ @ - @ - - - - - - @ - - - - @ - - @ @ - - - - - @ - - - - - - @ @ - - - - - - - - - - - - - - - - - - - @ - - - - - - - - - @ - - - - - - - - - @ -|
|- - - - - - - @ @ @ - - - @ @ @ @ - - - - - - - - - - - @ - - - - - - @ - - - - - - - - - - - - - - - - - - - - - @ - - @ @ @ @ @ - - - @ - - - - - - - - - @ - - - - - - - - - @ @ @ - - - - - - - - -|
|- - - - - - - - @ @ @ - - - - - - - - - - - - - - - - - @ @ - - - - - - - - - - - - - - - - - - @ @ @ - - - - - - @ - - - - - - - - - - @ - - @ @ @ - - - - @ - - - - - - - - - - @ @ - - - - @ @ - - -|
|- - @ - @ @ @ - - - - - - - - - - - - - @ @ - @ @ - - - - @ @ - - - - - - - - - - - - @ - - - - - - @ - - - - - - - - - - - - - - - - - @ - - - - - - @ @ - - - - - - - - - - - - - - - - - - @ @ - - -|
|- - @ - - - - - - - - - - @ @ @ - - - - @ @ - @ @ - - - - @ @ - - - - - @ @ @ - - - - @ - - - @ @ - @ - - - - - - - - - - @ - - - - - @ @ - - - - - - @ @ - - - - - - - - - - - - - - - - - - - - - - -|
|- - @ - - - - - - - @ @ - @ @ @ - - - - - - - - - - - - - - - - @ - - - - - @ - - - - @ - - - @ @ @ @ - - - - - - - - - - @ - - - - - @ @ @ - - - - - - - - - - - - - - - - - - - - - - - - @ @ @ - - -|
|- - - - - - @ @ @ - @ @ - @ - - - - - @ @ @ - - - - - - @ @ @ @ @ - - - - - @ - - - - - - - @ @ @ @ @ @ @ - - - - - - - - @ - - - - - - @ @ - - - @ - - - - - - - - - - - - - - - - - - @ - - - - - - -|
|- - - - - - - - - - - - - - - @ @ @ - - - - - - - - - - @ @ - - @ - - - - - @ - - - @ - - - - - - @ @ - - - - - - - @ - - @ - - - - - - - - - - - @ - - - - - - @ @ - - - - - - @ @ @ - @ - - - - - - -|
|- - - - @ @ @ - - - - - - - - - - - - - - - - - - - - @ @ @ - - - - - - - - @ @ - - @ - - - - - - - @ - @ @ @ - - - @ - @ @ - - - - - - - - - - @ @ - - - - - - @ @ - - - - @ @ @ @ - - @ @ - - - - - -|
|- - - - - - - - - - - - @ @ @ - - @ - - - - - @ @ - - - - - - - @ @ @ - - - - @ - - @ - - - - @ - - - - - - @ - @ - @ @ @ @ - - - - - - - - - - @ @ @ @ - - - - - - - - - - - - - @ - - @ @ - - - - - -|
|- - - - - - - - - - - - - - - - - @ - - - - - @ @ - - - - - - - - - - - - - - @ - @ @ - - - - @ - - - @ - - @ - @ - - @ - - - - - - - @ @ - - - - - - - - - @ @ - - - - - - @ @ @ @ - - @ @ - - - - - -|
|- - - - - - - - @ - - - - @ @ @ @ @ - - - - - @ - - - - - - - - - - - - - - - - - @ @ - - - - @ @ - - @ @ @ @ - @ - - @ - - - - - - - @ @ - - - - - - - - - @ @ - - - - - - - - - - - - @ @ @ - - - - -|
|- - - @ @ - @ @ @ - - - - @ @ @ @ @ @ @ - - - @ - - - - - - - - - - - - - - - - - - @ @ - - - - @ - - @ - - - - - - @ @ - - - - - - - @ @ - - - - - - - - - @ @ - - - - - - - - - @ - - - @ @ - - - - -|
|- - - @ @ - @ @ @ - - - @ @ - - - - - - - - - @ - - - - - @ @ @ - - - - - - - - - - - @ - - - - @ - @ @ - - - - - - @ @ - - - - - - @ @ - - - - @ - - - - - - @ - - - - - - - - - @ @ @ @ @ - - - - - -|
|- - - - - - @ @ - - - - @ - - - - - - - - - - - - @ @ @ - @ @ @ - - - - - - - - - - - @ - - - - - - @ @ - - @ - - - - - - - - - - - @ @ - - - - @ @ @ @ @ @ - @ - - - - - - - - - @ - - - @ - - - - - -|
|- - - - - @ @ @ @ @ @ - @ - - - - - - - - - - - - @ - - - - - @ - - - - - - - - - - - - - - - - - - @ @ @ @ @ - - - - - - - - - - - - - - - - - @ @ - - - - - - - - - - @ - - - - - - - - - - - - - - -|
|- - - - - - - - @ @ @ - - - - - - @ @ - - - - - - @ - - - - - - - - - @ - - - - - - - - - @ @ @ - @ @ - @ @ @ - - - - - - @ @ - - - - - - - - - - @ - - - - - - - - - - @ - - - - - @ @ @ - - - - - - -|
|- - - - @ @ @ - - - @ @ - - - - - @ @ - - - - - - @ - - - - - - - - - @ - @ @ @ - - - - @ @ @ @ - @ @ - - - - - - - - - - @ @ - - - - - - - - - - @ - - - @ @ @ - - - - @ - - - - - - - @ - - - - - - -|
|- - - - - - - - - - - @ @ @ - - - - - - - - - - - @ @ @ - - - - @ - @ @ - - - - - - - - - - - @ - - - - - - - - - - - - - - - - - - - - - - - - - - - - - - - @ @ @ - - - - - - - - - - @ - - - - - - -|
|- - @ @ @ - - - - - - @ - - - - - - - - - - - - - - @ @ - - - - @ - @ @ @ @ - - - - - - - - - @ - - - - - - - - - - - - - - - - - - @ @ @ - - - - @ @ - - - - - @ @ @ - - - - - - - @ @ @ - - - - - - -|
|- - @ @ - - - - - - - - - - - - - - - - - - - - - - - - - - - - @ - - - @ @ - - - - - - - - - @ - - - - - - - - - - - - - - - - - - - - - - - - @ @ @ - - - - - - - @ @ @ - - - - - - - - - - - - - - -|
|- - - - - - - - - - - - - - @ - - - @ @ @ - - - - - - - - - - - - - - - - - - - - - - - - - - @ - - - @ - - @ @ - - - - - - - - - - - - - - - - @ - - - - - - - - - @ @ @ - - - - - - - - - - - - @ - -|
|- - - - - - @ @ - - - - - - @ - - - @ @ @ - - - - - - @ @ @ - - - - - - - - - - - - @ @ - - - @ - - - @ - - @ @ - @ @ @ - @ @ @ - - - - - - - - @ - @ @ - - - - - - - @ @ - - - - - - - - - - - - @ @ @|
|- - - - - - @ @ @ - - - - - @ - - - @ - - - - - - - - - @ - - - - - - - - - - - @ @ @ @ @ @ @ @ - - - @ - - - - - - - - - - - - - - - - - - - - @ - @ @ - @ @ - @ @ @ @ - - - - - - - - - - - - - @ - -|
|@ @ - - - - - - @ - @ @ @ - - - - - - - - - - - - - - - @ @ @ - - - - - - - - - - - - - - @ @ - - - - - - - - - @ @ - - - - - - - - - @ @ - - - - - - - - @ @ - - - - @ - - - - - - @ @ - - - - @ @ @ @|
|- - - - - - - - @ - - - - - @ @ @ - - - - - - - - - - - @ @ @ - - - - - - - - - - - - - - @ @ - - - - - - - - - @ @ - - - - - - - - - @ @ - - @ @ - - - - - @ - - - - @ - - - - - - @ @ - - - - - - @ @|
|- - - - - - @ @ @ @ - - - @ @ @ - - - - - - - - @ - - - - - @ @ @ - - - - - - - - - - - - - @ - - - - - - - - - - - - - - - - - - - - - - - - @ @ - - - - - @ - - - - - - - - - - - - - - - - - - - - -|
|- - - - - - - - - - - - - - - - - - - - @ @ @ - @ @ @ - - - - - - - - - - - - - - - - - - - @ @ @ - - @ @ @ @ - - - - - - - - - - - - - - - - - - - - - @ @ @ - - - - - - - - - - - - - - - - - - - - -|
|- - - - - - - - - - - - - - - - - - - - - - - - @ - - - - - - - - - - - - @ @ @ @ @ - - - - - - - - - @ - - - - - - - - - - - - - - - - - - @ - - - - - - - @ - - - - - - - - - - - - - - - - - - - - -|
|- - - - - - - - @ @ - - - - - - - - - - - - - - - - @ @ @ - - @ @ @ - - - - @ @ - - - - - @ @ - - @ @ @ - - - @ - - - - - - - - - - @ @ - - @ - - - - - - - @ @ @ - - - - @ @ - - - - - - - - - - - - -|
|- - - @ @ @ - - @ @ - - - - - - - - - - - - @ - - - @ @ @ - - - - - - - - - @ @ - - - - - @ @ - - @ @ - - - - @ - - - - - - - - - - @ @ @ @ @ - - - @ @ @ - - @ @ - - - - @ @ - - - - - - - - - - - - -|
|- - - - - - - - - - - - - - - - - - - - - - @ - - - @ - - - - - - - - - - - - - - - - - - - - - - - - - - - - @ - - - - - - - - - - @ - - - - - - - - - @ @ @ @ - - - - - - - - - - - - - - - - - - - -|
