100 20
|@ @ - - - - - - - - - - - - - @ @ @ - - - - - - - - - - - - - - @ @ - - - - - - - @ @ @ @ - - - - - - - - - - - - - - - - - - - - - - - - @ @ - - - - - - @ - - - - - - - - - - - - - - - - - @ @ @ - @|
|@ @ - - - - - - - - - - - - - - - - - - - - - @ @ - - - - - - - @ @ - - - - - - - - - - @ - - - @ @ - - - - - - - - - - - - - - - - - - - @ @ - - - - - - @ - - - - - - - - - - - - - - - - - - - - - @|
|- - - - - - - - - - - - - - - - - - - - - @ @ @ @ - - - - - - - - @ - - - - - - - - - - @ @ - - @ @ - - - - @ @ - - - - - - - - - - - @ @ @ @ @ - - - - @ @ @ - - - - - - - - - - - - - - - @ @ - - - -|
|- - - - - - - - - - @ - - - - - - - - - - - - - - - - - - @ @ @ - @ @ - - - - - - - - - - @ @ - @ @ @ - - - @ @ - - - - - - - - - - - - - - - @ @ @ @ - - - - - - - - - - - - - - - - - - - @ @ - - - -|
|- - - - @ @ - - - - @ - - - - - - - - - - - - - - - - - - - - - - @ @ - - - - - - - - - - @ @ - - - - - - - - - - - - - - - - @ - - - - - - - - - - @ @ @ - - - - - - - - - @ - - - - - - - - - - - - -|
|- - - - @ @ - - - - @ - - - - - - - - @ - - - - - - - - - - - - - - - - - - - - - - - - - @ @ - - - - - - @ @ - - - - - - - - @ - - - - - - - - - - - - - - - - - - - - - - @ - - - - @ - - - - - - - -|
|- - - - - - - - - - - - - - @ @ @ - - @ - - - - - - - - - @ @ @ - - - - - - - - - @ - @ @ @ - - - - - - @ @ @ - - @ - - - - - @ @ @ - @ @ @ - - @ - - - - - - - - - - - @ @ @ - - - - @ - - - - - - - -|
|@ @ - - - - - - - - - - - - - - - - - @ - - @ @ - - - - - - - - - - - - - - - - - @ - @ @ @ - - - - - - @ @ - - - @ - - @ @ - - - - - - @ @ - - @ - @ @ - @ - - - - - - @ @ - - - - - @ - - - - - - - -|
|@ @ @ @ - - - - - - - - @ - - - - - - - - - @ @ - - - @ @ - @ @ @ - - - - - - - - @ - - - - - - - - - - - - - - @ @ - - @ @ @ - - - - - @ @ - - @ - @ @ @ @ - - - - - - @ @ @ - - - - - - - - @ @ - - -|
|- - @ @ - - - - - - - - @ - - - - - - - - @ @ @ - - - @ @ - - - - - - - - - - @ @ @ - - - @ - - - - - - - - - - @ @ - - - - @ - - - - - @ - - - - - - - @ @ - - - - - - - @ @ @ @ @ @ - - - - @ @ - - -|
|- - - - - - - - - - - - @ - - - - - - - - @ - - - - - @ - - - - - - - - - - - @ @ @ - @ - @ - - - - - - - - - - - - - @ @ @ @ - - @ @ - @ - - - - - @ - - @ @ @ - - - - - @ - @ @ - - - - - - - - - - -|
|- - - - - - - - - - - - @ - - - - - @ @ - @ - - - - - @ @ - - - - - - - - - - @ - - - @ @ @ - - - @ @ @ - - - - - - - - - @ @ @ - @ @ - @ - - - - - @ - - - - - - - - @ @ @ - - - - - - - - - - - - - -|
|- - - - - - - - - - - - @ - - @ @ @ @ @ - - - - - - - @ @ - - - - - - - - - - @ @ - - @ @ - - - - - - - - - - - - - - - - - - - - - - - - - - - - - @ - - - - - - - - - - - - - - - - - - - - @ @ @ - -|
|- - - - - - - - - - - - @ - - - - - - - - - - - - - - - @ - - @ @ @ @ - - - - @ @ - - @ @ - - - - - - - - - - - - - - - - - - - - - - - - - - - - - - - - - - - - - - @ @ @ @ - - @ @ @ - - - - - - - -|
|- - - @ - - - - - - - - - - - @ - - - - @ @ @ - - - - - - - - @ @ - - - - - - - - - - @ - - - - - - - - - - @ - - - - - - - - - - - - - - - - - - - - - - @ - - - - - - - @ @ - - - - - - - - - - - - -|
|- @ - @ - @ @ @ - - - - - - - @ - - - - - - - - - - - - - - - - - - - - - - - - - - - @ @ @ @ - - - - - - - @ - - - - - - - - - - - - - - - - - - - - @ @ @ - - - - - - - - @ @ @ - - - - - - - - - - -|
|- @ - @ @ @ @ - - - - - - - - @ - - - - - - - - - - @ @ - - - - @ - - - - - - - - - - - - - - - - - - - - - @ - - - - @ @ @ - - - - - - - - - - - - - @ @ @ - @ @ @ - - - - - @ @ - - - - - - - - - - -|
|- @ - - @ @ @ - - - - - - - - - - - - - - - - - - - @ @ - - @ - @ - - - - - - - - - - - @ @ @ - - - - - - - - - - - - - - - - - - - @ @ @ @ - - - - - - - - - - - - - - - - - - - - - - - - - - - - - -|
|- @ @ @ @ - @ - - - - - - - - - - - - - - - - - - - - - - - @ - @ - - - - - - - - @ - - - - - - - - - - - - - - - - - - - - - - @ @ @ - - - - - - - - - - - - - - - - - - - - - - - - - - - - - @ - @ @|
|- - - - - - @ @ @ - - @ @ - - - - - @ @ - - - - - @ @ - - - @ - - - - - - - - - - @ - - - - - - - - - - - - - - - - - - - - @ @ @ - - - - - - - - - - - - - - @ @ @ - @ @ - - - - - - - - - - - @ - @ @|
