20 20
|- - - - - - - - - - - - - - @ @ @ - - -|
|- - - - - - - - - - - @ @ - @ @ @ - - @|
|@ - - - - - - - @ - - @ @ - - - - - - @|
|@ - @ - - - - - @ - - - @ @ @ - - @ @ @|
|@ - @ @ @ - - - @ @ @ - - - - - - @ - -|
|@ @ @ @ @ - - - - - @ - - - - - - @ - -|
|- - - - @ - - - - - @ - - - - - - @ @ @|
|- - - - - - - @ @ - @ - - - - - - @ @ @|
|@ @ @ - - - - @ @ - - - @ - - - - @ - -|
|- @ - - @ @ @ @ @ @ @ @ @ - - - - @ @ @|
|- @ - - - - @ @ @ @ - - @ - - - - @ @ -|
|- @ - - - - @ - - @ @ @ @ @ @ @ @ @ - -|
|- - - - - - @ - - @ - - @ - @ @ @ @ - -|
|- - @ @ @ - @ - - @ - - @ @ @ @ @ - - @|
|- - @ @ @ - @ - - @ @ @ @ @ @ @ - - - @|
|- - @ @ @ @ @ - - @ @ @ @ @ @ @ - - - @|
|- - @ @ - @ - - - @ @ - @ @ @ @ @ - - -|
|- - @ @ - @ @ - - - - - - @ @ - @ @ - -|
|- - - - - - @ @ @ - - - - - @ - @ @ - -|
|- - - - - - @ @ @ @ - - - - @ - - - - -|
