10 10
|- - - - - - - - - -|
|- - - - - - - - - -|
|@ @ @ - - - - - - -|
|- - - - - - - - - -|
|- - - - - - - - - -|
|- - - - - - - - - -|
|- - - - - - - - - -|
|- - - - - - - - - -|
|- - @ - - - - - - -|
|- - @ - - - - - - -|
