20 200
|- - - - - - - - - @ - @ - @ @ - - - - -|
|- - - - - - - - - @ - @ @ @ @ - @ - - -|
|- - - - - - - - - - - @ @ - - - @ - - -|
|- - - - - - - - - - - - @ - - @ @ - - -|
|- - - - - - - - - - - - @ - - @ @ - - -|
|- - - - - @ @ @ - - - @ @ - - - - - - -|
|- - - - - @ @ @ - - - @ @ - - @ @ - - -|
|- - - - - - - - - - - - - - @ @ @ - - @|
|- - @ @ @ - - - - - - - - - @ - - - - @|
|- - @ @ @ - - - - - - - - - @ - - - - @|
|- @ @ - - - - - - - - - @ @ @ - - - - -|
|- @ @ - - - @ @ @ - - - @ @ - - - - - -|
|- - - - - - - - - - - - - @ - - - - - -|
|- - - - - - @ @ @ - - - - @ - - - - - -|
|@ @ @ @ @ - - - - - - - - - - - - - - -|
|- - - @ @ - - - - - - - - - - - - - - -|
|- - - - - - - @ @ - - - - - - - - - - -|
|- - - - - @ @ @ @ - - - - - - - - - @ @|
|- - @ @ @ @ - - - - - - - - - - - - @ @|
|- @ @ - - - - - - - - - - - - - - - - -|
|- @ @ - - - - - - - - - - - - @ @ @ - -|
|- - - - - - - @ @ @ - - - - - @ @ - - -|
|- - - - - @ @ @ - - - - - - - - - - - -|
|- - - - - - - - - - - - - - - - - - - -|
|- - - - - - - - - @ @ - - - - - - - - -|
|- - - - - - - - @ @ @ - - - - - - - - -|
|- - @ @ - - - - - - - - - - - - - - - -|
|- - @ @ - - - - - - - - - - - - - - - -|
|- - - - - - - - - - - - - @ @ @ - - - @|
|- - - - - - - @ @ - - - @ @ - @ @ @ - @|
|- - - - - - - @ @ @ - - @ - - - @ @ - -|
|- - - @ @ - - - - @ - - @ - - - @ - - -|
|- - - @ @ - - - - @ - - - - - - - - - -|
|- - - - - - - - - - - - - - - - - - - @|
|- - - - - - - - - - - - @ @ - - - - @ @|
|- - - - - - - - - - - @ @ @ - @ @ @ @ @|
|- - - - @ @ - - - - @ @ - @ - @ @ @ @ @|
|- - - - @ @ - - - - @ @ - @ @ @ - - @ @|
|- - - - - - - - - - - @ - - - - - - - -|
|- - - - - - - - - - - - - - - - - - - -|
|- - - - - - - - @ - - - - - - - - - - -|
|- - @ @ @ @ - - @ - - @ @ - - - - - - -|
|- - - - @ @ - - @ @ - @ @ - - @ @ @ - -|
|- - - - - - - - - @ - - - - - - - - - -|
|- - - - - - - - - @ - @ - - - - - - - -|
|- - - - - - - - - @ @ @ - - - - - - - -|
|- - - @ - - - - - - @ @ - - - - - - - -|
|- - - @ - - - - - - - - - - - - - - - -|
|- - - @ - - - - - - - - - @ @ - - - - -|
|- - - @ @ - - - - - - - - @ @ - - - - -|
|- - - @ @ - - - - @ @ - - - - - - - - -|
|- - - @ @ - - - - @ @ - - - - - - - - -|
|- - - - - - - - - - - - - - - - - - - -|
|- @ @ @ - - - - @ - - - - - @ - - - - -|
|- - - - - - - @ @ - - - - - @ - - - - -|
|- - - - - - - @ @ @ @ - - - @ - @ @ - -|
|- - - - - - - - @ @ @ - - - @ @ @ @ @ -|
|- - - - - - - - @ - - - - - @ @ - @ @ -|
|- - - - - - - @ @ - - - - - - - - - - -|
|- - - - - - - @ - - - - - - - - - - @ @|
|- - - - - - - @ - - - - - - - - - - - -|
|- - @ @ @ - - - - - - - - - @ @ @ - - -|
|- - - - - - - - - - - - - - - - - - - -|
|@ @ @ @ - - - - - - - @ - - - - - - - -|
|- - - @ - @ - - - - - @ - - - - - - - -|
|- - - @ - @ - - - - - @ - - - - - - - -|
|@ @ @ @ - @ - - - - - - - - - - - - @ @|
|@ @ - - - - - - - @ - @ @ - - - - - - -|
|@ @ - - - - - - - @ - @ @ - - - @ - - -|
|- - - - - - @ @ @ @ - - - - - - @ - @ -|
|- - - - - - - @ @ @ - - - - - - @ - @ -|
|- - - @ @ @ - - @ @ @ - - - - - - - @ -|
|- - @ @ - - - - - - - - - - @ @ @ @ @ @|
|- - @ - - - - - - - - @ @ @ @ @ - - - -|
|@ @ @ - - - - - - @ @ @ @ - @ @ @ @ - -|
|- - - - - @ @ @ - @ @ - - - - @ @ @ @ @|
|- - - @ - - - - - - - - - - - - - - - -|
|- - - @ - - - - - - @ @ @ - - - - - - -|
|- - - @ - - - - - - - @ - - - - - - - -|
|- - - - - - - - - - - @ - - - - - - - -|
|- - - - - - - - - - - @ - - - - @ @ @ @|
|- - - - - - - - - - - - - - - - - - - -|
|- - - - - - - - - - - - @ @ @ @ - - - -|
|- - - - - - - - - - - @ @ - @ @ - - - -|
|- - - - - - - - - - @ @ @ - @ @ - - - -|
|- - - - - - - - - - @ @ @ @ @ - - - - -|
|- - - - - - - - - @ @ - - - @ @ - - - -|
|- - @ @ @ - - - @ @ - - @ @ @ @ - - - -|
|- - - - - - - - @ @ - - - - - @ - - - -|
|- - - - - - - - - - - - - - - - - - - -|
|- - - - - - - - - - - - @ @ @ - - - - -|
|- - - @ @ - - - - - - - - - - - - - - -|
|- - - @ @ @ - - - - - @ @ @ @ - - - - -|
|- - - - - @ @ @ - - - @ - - - - - - - -|
|- - - @ - - - - - - @ @ @ - - - - - - -|
|- - - @ - - - @ - - @ - @ - - - - - - -|
|- - - @ - - - @ - - @ - @ - - - - - - -|
|- - - - - - - @ - - @ - - - - - - - - -|
|- - - - - - - - - - @ - - - @ - - - @ @|
|- - - - - - - - - - @ - - - @ - - - @ @|
|- - - @ @ - - - - - - - - - @ @ @ @ @ -|
|- - - @ @ - - - - - - - - - - - - - @ -|
|- - - - - - - - - - - @ @ @ - - - - - -|
|- - - - - - - - - - - - - - - - - - - -|
|- - - - - - - @ - - - @ @ @ - - - - - -|
|- - - @ @ @ - @ - - - - - - - - - - - -|
|- - - - - - - @ - - - - @ @ - - - - - -|
|- - - - - - - - - - - - @ @ - - - - - -|
|- - @ @ @ - - - - - - - - - - - - - - -|
|- - @ @ - - @ @ @ - - - - - - - - - - -|
|- - - - - - - - - - - - - - - - - - - -|
|- - - - - - - - - - - - - - - - - - - -|
|- - - - - - - - - - @ @ @ - - - - - - -|
|- - - - - - - - - - - - - - - - - - - -|
|- - - - - - - @ @ @ - - - - - - - - - -|
|- - - - - - - @ @ @ - - - - - - - @ @ @|
|- - - - - - - - - @ - - - - - @ @ @ @ -|
|- - - - - - - - - @ - @ @ - - @ - - - -|
|- - - - - - - - @ @ - @ @ - - @ - @ @ @|
|- @ @ @ - - - @ @ @ - - - - - @ - @ - -|
|- - - - - - - @ @ - - - - - - - - @ - -|
|- - - - - - - - - - - - - - - - - @ - -|
|- - - - - - - - - - - - - - - - - @ @ -|
|- - - - - - @ @ - - - - - - - - - - @ -|
|- - - - - - @ @ - - - - - - - - - - @ -|
|- - - - - - - - - - - - - - - - @ @ @ -|
|- - - @ @ - - - - - - - - - - - - @ @ @|
|- @ @ @ @ - - - - - - - - - - - - @ @ @|
|- @ @ @ @ - - - - - - - - - - - - - - -|
|- - - - @ @ - - - @ @ @ - - - - - - - @|
|- - - - @ @ - - - - - - - - - - - - - @|
|- @ - - - - - - - - - - - - - - - - @ @|
|- @ - - - - - - - - @ @ - - - - - - @ -|
|- @ - - - - - - - - @ @ - - - - - - @ -|
|- - - - - - - - - - - - - @ @ - @ - - -|
|- - - - @ @ - - - @ @ @ - @ @ - @ - @ @|
|- - - - @ @ - - - - - - - - - - @ @ @ @|
|- - - - - - - - - - - - - - @ @ @ @ - -|
|- - - - @ @ - @ @ @ - - - - @ @ - - - -|
|- - - - @ @ - - - - - - - - - - - - @ @|
|- - - - - - - @ @ - - - - - - - - @ @ @|
|- - - - - - @ @ @ - - - - - - - - @ @ -|
|- - - - - - @ - - - - - - - - - - - - -|
|- - - - - - @ - @ - @ @ - - - - - - - @|
|- - - - - - @ @ @ - @ @ - - - - - - - @|
|- - - - - - - @ @ - - - - - - - - @ @ @|
|- - - - - - - @ - - @ @ - - - - - - - -|
|@ @ @ @ - - - @ - - @ @ @ @ - - - - - -|
|- - - - - - - @ - - @ @ - @ @ @ - - - -|
|- - - - - - @ @ - - - - - - - - - - - -|
|- - - - @ @ @ - - - - - - @ @ - - - - -|
|- - - - @ @ @ - - - - - - @ @ - - - @ -|
|- - - - - - - - - - - - - - - - - - @ -|
|- - - - @ @ @ - - - - - - - - @ @ - @ -|
|- @ - - @ - - - - - - - - @ @ @ @ - - -|
|- @ - - @ - - - - - - - - - - - - - - -|
|- @ - - @ - - - - - - - - - @ @ - - - -|
|- - - - - - @ @ @ - - - - - @ @ @ - - -|
|- - - - - - @ @ @ - - - - - - @ @ - - -|
|- - - - - - - @ @ - - - - - - - - - - -|
|- - - @ @ - - @ @ - - - - - - - - - - -|
|- - - @ @ - - - - - - - - - - - - - - -|
|@ @ @ @ - - - - - - - - - - - - - - - -|
|- - - - - - - - - - - - - - - - - - - -|
|- - - - - - - - - - - - - - - - - - - -|
|- - - - - - - - - - @ @ @ - - - - - - -|
|- - - - - - - - - - @ @ @ - - - - - - -|
|- - @ - - - - @ @ - - @ @ - - - - - - -|
|- - @ - - - - @ @ - - - - - - - - - - -|
|- - @ - - @ - - - - - - - - - - - - - -|
|- - - - - @ - - - - - - - - - - - - - -|
|- - - - - @ - @ - - - - - - - - @ - - -|
|- - - - - - - @ @ @ - - - - - - @ - - -|
|@ @ - - - - - @ @ @ - - - - - - @ - - -|
|@ @ - - - - - - - - - - - - - - - - - -|
|- - - - - - - - - - - - - - - - - - - -|
|- - - @ @ - - - - - - - - - - - - - - -|
|- - @ @ @ - - - - - - @ @ - - - - - - -|
|@ @ @ @ - - - - - - - @ @ @ @ @ - - - -|
|- - - @ @ - - - - - - - - - @ @ @ @ @ @|
|- - - @ @ - - - @ @ @ - - - - - - - - -|
|- - - - - - - - - - @ - - - @ @ - - - -|
|- - - - - - - - - - @ - - - @ @ - - - -|
|- - - - - - - - - - @ @ - - - - - - - -|
|- - - - - - - - - - @ @ - - - - - - - -|
|- - - - - - - - - - - - - - - - - - - -|
|- - - - - - - - - - - - - - @ @ - - - @|
|- - - - @ @ - - - - - - - - @ @ - @ @ @|
|- - - - @ @ - @ - - - - @ @ @ @ - @ @ @|
|- - - - - - - @ - - - - @ - @ @ - - - -|
|- - - - - - - @ - - - @ @ @ @ @ - - - -|
|- - - - - - - - - - - - @ @ @ - - - - @|
|- - - - - - - - - - - - - - - - - - - @|
|- - - - - - - - - - @ @ - - - - - - - -|
|- - - - - - - - - - @ @ @ @ - - - - - -|
|- - - - - @ @ - - - - - - - - @ @ - - -|
|- - @ - - @ @ - - - - - - - - @ @ - - -|
|- - @ - - - - - - - - - - - - - - - - -|
|- - @ @ @ - - - - - - - - - - @ @ - - -|
|- - @ @ @ - @ @ @ - - - - - - @ @ @ @ -|
