14 11
|- - @ @ @ @ @ @ @ @ @ - - -|
|- - - @ @ @ @ @ - - - - @ -|
|- - - @ @ - - - - @ - - @ -|
|@ - - - - - @ @ @ @ @ @ @ -|
|@ @ @ @ @ @ @ - - - - - - -|
|@ @ - - - - - - - @ @ @ @ @|
|- - - @ @ @ @ @ @ @ - - - -|
|- @ @ @ - @ - - - - - @ @ -|
|- @ - - - - - @ - @ @ @ - -|
|- - - - - @ @ @ @ @ - - - @|
|@ @ @ @ @ @ @ @ @ @ - - @ @|
