20 20
|- - - - - - - - - - @ @ @ - - - - - - -|
|- - - - - - - - - - @ @ - - - - - - - -|
|- - - - - - - - - - @ @ - - - - - - - -|
|- - - - - - - - - - - - - - - - - - - -|
|- - - - - - - - - - - - - - - - - - - -|
|- - - - - - - - - - - - - - - - - - - -|
|- - - - - - @ - - - - - @ @ @ - - - - -|
|- @ - @ @ @ @ - - - - - - - - - - - - -|
|- @ - - - - @ - - - - - - - - - - - - -|
|- @ @ - - - - - - - - - - - - - - - - -|
|- - @ - - - - - - - - - - - - - - - - -|
|- - @ - - - - - - - - - - - - - - - - -|
|- - @ - - - - - - - - - - - - - - - - -|
|- - - - - - - - @ - - - - - - - - - - -|
|- - - - - - - - @ - - - - - - - - - - -|
|- - - - - - - - @ - - - - - - - - - - -|
|- - - - @ @ @ - - - - - - - - @ - - - -|
|- - - - - - - - - - - - - - - @ - - - -|
|- - - - - - - - - - - - - - - @ - - - -|
|- - - - - - - - - - - - - - - - - - - -|
