100 50
|- - - @ @ - - - @ @ - - - - @ @ - - - - @ @ - - - - - - - - - - - - - - @ @ - - - - - - - - - - - - - - - - - - - - - - - - - - - - - - - - - - - - - - - - - - - - - @ - - - - - - - - - - - - - - - -|
|- - - @ @ - - - @ @ - - - - @ @ - - - - @ @ - - - - - - - - - @ @ - - - @ @ - - - - - - - - - - - - - - - - - - - - - - - - - - @ @ @ - - - - - - - - - - - - - @ @ - @ - - - - - - - @ @ @ - - - - - -|
|- - - - - - - - - - - - - - - - - - - - - - - - - - - - - - - @ @ - - - - @ @ @ - - - - - - - - - @ @ @ - - - - - - - - - - - - - - - - - - - - - - - - - - - @ @ @ - @ - - - - - @ @ @ - - - - @ @ @ -|
|- - - - - - - @ @ @ - - @ - - - - - - - - - - - @ @ @ - - - - @ @ @ - - @ @ @ - - - - @ @ - - - - - - - - - - - - - - - - - - - - - - - - - - - - - - - - - - - - - - - - - - - - - - - - - - - - - - -|
|- - - - - - - @ @ - - - @ - - @ @ @ - - - - - - - - - - - - - - @ - - - - - - - @ - - @ @ - - - - - - - - - - - - - - - - - - - - - - - @ @ - - - - - - - - - - - - - - - - - - - - - - @ - - - - - - -|
|- - - - - @ - - - - - - @ - - - - - - - - - - - - - - - - - - - @ - - - - - - - @ @ - - - - - - - - - - - - - - - - - - - - - - - - @ @ @ @ - - - - - - - - - - - - - - - - - - - - - - @ @ @ - - - - -|
|- - - - - @ - - - - - - - - @ - - - - - - - - - - - @ @ @ - - @ @ - - - - - - - @ @ - - - - - - - - - @ - - - - - @ - - - - - - - - @ @ - @ - - - - - - - @ @ @ - @ @ @ - - - - - - - - @ @ @ - - - - -|
|- - - - - @ - - - - - - - - @ - - - - - - - - - @ - - @ - - - @ @ - - - @ @ @ - - @ - - - - - - @ @ - @ - - - - - @ - @ - - - - - - - - - @ @ @ @ - - - - @ @ - - - - - - - - - - - - - - - - - - - - -|
|- - - - - - - - - - - - - - @ - - - - - - - - - @ - - @ - - - - - - - - - - - - - - - - - - - - @ @ @ @ - - - - - @ - @ - - - - - - - - - @ - - @ @ - - - - @ @ @ - - - - - - - - - - - - - - - - @ @ -|
|@ @ - - - - - - - - - @ - - - - - - - - @ - - - @ - - - - - - - - - - - - - @ - - - - - - - - - - - @ - - - - - - - - @ @ @ - - - - - - - - - - @ @ - - - - - - - - - - @ - - - - - - - - - - - - @ @ -|
|@ @ - - - - - - - - - @ - - - - - @ @ - @ - - - - - - - - - - - - - - - - - @ - - - - - - - - - - - @ - - - - - - - - - - - - - - - @ @ @ @ - - - - - - - @ @ @ - - - - @ @ @ @ - - - - - - - - - @ @ -|
|- - - - - - - - - - - @ - - - - - @ @ - @ - - - - - - - - @ @ @ - - - - - - @ - - - - - - - @ @ - - @ @ @ - - - - - - - - - - - - - - - - @ @ @ - @ @ @ - @ @ - - - - - @ - - - - - - - - - - - - - - -|
|@ - - - - - - - - - - - - - - - - - - - - - - @ @ @ - - - @ - - - @ @ - - - - - - - - - - - @ @ - - - - - - - - - - - - - - - - - - - - - - - - - @ @ @ - @ @ - - - - - - - - - - - @ @ - - - @ @ - - -|
|@ - - @ @ @ - - - - - - - - - - - - - - - - - - - - - - - @ - - - @ @ @ @ - - - - - - - - - - @ - - - @ @ - - - - - - - - - - - - - - - - - - - - @ @ - - - - - - - - - - @ @ - - - @ @ - - - @ @ @ - -|
|@ - - @ @ @ - - - - - - - - - - - - - - - - - - - - - @ @ @ @ @ @ @ - - @ - - - @ @ - - @ @ @ @ - - - @ @ @ - - - - - - - - - - - - - - - - - - - - @ - - - - - - - - - - @ @ - - @ @ @ - - - - - - - -|
|@ - - @ @ - - - - - - - - - - - - - - - - - - - @ @ @ @ @ - - - - - - - @ - - - @ @ - - - - - @ @ @ @ @ - @ @ - - - @ @ - - - - - - - - - - - - - - @ - - - - - - - - - - - - - - @ - @ @ - - - - - - -|
|- - - - @ @ - - - - @ @ - - - - - - - - @ @ - - - - @ @ - - - - - - - - - - - - - @ - - - - - - - @ @ @ @ @ @ @ @ @ @ @ - - - @ - - @ @ @ - - - - @ @ - - - - - - - - - - - - - - @ - @ @ - @ @ - - - -|
|- - - - @ @ - - - - @ @ - - - - - - - - @ @ - - - - @ @ - - - - - - - - - - - - - @ - - - - @ @ - @ @ @ - - - - - - - @ - - - @ - - @ @ @ - - - - @ - - - - - @ @ - - - - - - - - - - - - - @ @ - - - -|
|- - - - - - - - @ - @ @ @ @ - - - @ - - - - - - - - - @ - - @ @ @ - - - - - - - - @ @ - - - @ @ - @ @ @ - - - - @ @ - @ - - - @ @ - - - - - - - - @ - - - - - @ @ - - - - - - - - - - - - - @ @ @ @ @ -|
|- - - - - - - - @ - - - - - - - - @ - - - - - - @ @ - - - - - @ - - - - - - - @ @ @ @ - - - - - - @ - - - - @ - @ @ - - - - @ @ @ - - - - - - - - - - - - - - - - - - - - - - - - - - - - - - - - @ @ @|
|- - - - - - - - @ - - - - - - - - @ @ - - - - - @ @ - - - - - @ - - - - - - - - - - - - @ @ - - - - - - - - @ - @ @ - - - - @ - @ - - - - - - - @ - - - - - - @ @ @ - - - @ @ - - - - - - - @ - - - - @|
|- - @ - - - - - - - - - - - - - - - @ - @ @ @ @ @ - - - - - - @ - - - - - - @ @ @ - - - @ @ - - - - - - - - @ - - - - - - - @ - - - - - - - - - @ - - - - - @ @ @ @ @ - - @ @ - - - - - - - @ - - - - -|
|- - @ - - - - - - - - - - - - - - - @ - @ @ - - - - - - - - - - - - - - - - - - - - - - - @ @ @ - - - - - - - - - - @ @ - - - - - - - - - - - - @ - - - - - @ - - - @ @ - - - - - - - - - - @ @ @ @ - -|
|- - @ - - - - - - - - - - - - - - - @ @ @ @ - - - - - - - - - - - - - - - - - - - - - - - - - - - - - - @ @ @ @ @ - @ @ @ @ @ - - - - - - - - - - - - - - - @ - - - @ @ - - - - - - - - - - - - - - - -|
|- - - - - - - - - - - - @ @ - - - - - - - - - - - - - - - - - - - - - - - - - - - - - - - - - - - - - - @ @ - - - - - - - - - - - - - - - - - - - - - - - - - - - - - - - - - - - - - @ - - - - - - - -|
|- - - - - @ - - - - - - @ @ @ - - - @ - - - - - - - - - - - - - - - - - - - - - - - - @ @ @ @ - - - - - @ @ @ - @ - - - - - - @ @ @ - - - - - - - @ @ @ - - - - - - - - - - - - - - - @ - - - - - @ @ @|
|- - - - - @ - - - - - - - @ @ - - - @ @ @ @ @ - - - - - - - - @ @ @ - - - - - - - - @ @ - - - - - - - @ @ @ @ @ @ - - - - - - - - - - @ @ @ - - - @ @ @ - - - - - - - - - - - - @ @ @ @ - - - - - - - -|
|- - - - @ @ @ - - - - - - - - - - - @ @ - - - - - - - - - - - - - - - - - - - - - - @ @ - - - - - - - @ @ - @ @ @ - - @ @ @ - - - - - - - - - - - @ - - - - - @ @ @ - - - - - - - - - @ - - - - - - - -|
|- - - - @ @ @ - - - - - - - - - - - - @ @ @ @ - @ @ @ @ - - - @ @ - - - - - - - - - - - - - - - - - - @ @ - - - - - - @ @ @ @ - - - - - @ @ @ - - - - - - - - - - - - - - - @ @ - - - @ - - - - @ @ - -|
|- - - - - - - - - - - - - - - - - - - - - - @ - - - - - - - - @ @ - - - - - - - - - - - - - @ @ @ - - @ - - - - - - - - - - - - - - - - - - - - - - - - - - - - - - - - - - @ @ - - - @ - - - - @ @ - -|
|- - - - - - - @ - - - - - - - - - - - - - - @ - - - @ - - - - - - - - - @ @ - - - - - - - - - - - - - @ - - - - - - - - - - - - - - - - - - - - - - @ @ @ - - - - @ - - @ @ @ - - - - - - - - - - - - -|
|- - - - - - - @ - - - - - - - - - - - - - - - - - - @ - - - - - - - - - @ @ - - - - - - - - - - - - - - - - - - - - - @ - - - - - - @ @ - - - - - @ @ - - - - - - @ - - - - - - - - - - - - - - @ - - -|
|- - - - - - - @ - - - - - - - - - - - - - - - - @ @ @ - - - - - - - - - - @ @ - - - - - - - - - - - - - - - - - - - - @ - - - - - - @ @ - - - - - @ - - - @ @ - - @ - - - - - - - - - - - - - - @ - - -|
|- - - - - - - - - - - - - - - - - - - - - - - - - - - - - - - - - - - - - @ @ @ - @ - - - - - - - - - - - - @ @ @ - - @ - - - - - - - - - - - - @ @ - - - @ @ - - - - - - - - - - - - - - - - - @ @ - -|
|- - - - - - - - - - - - - - - - @ @ - - - - - - - - - - @ - - - - - - - - - - @ - @ - - - - - - - @ - - - - - - - - - - - - - @ @ @ - - - - - - @ @ - - - - - - - - - - - - - - @ @ - - - - - - - @ - -|
|- - - - - - @ @ @ - - - - - - - @ @ @ - - - @ @ @ - - - @ - - - - - - - @ @ @ @ @ @ - - - - - - @ @ - - - - - - - - - - - - - @ @ @ @ @ - - - - @ @ - - - - - - - - - - - - - - @ @ - - - - - - - @ - -|
|- - - - - - - - - - - - - @ @ @ @ @ @ - - - - - - - - - @ - - - - - - - - - - @ @ - - - - - - - @ @ @ @ @ - - - - - - - - - - - - - - - - - @ - @ @ - - - - - - - - - - - - - @ @ @ - @ @ - - - - @ - -|
|- - - - - @ @ @ - - - - - - - - @ @ @ - - - - - - - - - - - - - - - - - @ - - - - - - - - - - - - - @ @ @ - - - - @ @ @ @ @ @ - - - - - - - @ - - - - - - - - - - @ - @ - - - @ @ - - @ @ - - - - - - -|
|- - - - - - @ @ @ - - - - - - - - - - - - - - - - - - - - - - - @ @ - - @ - - @ @ @ @ @ - - - - - @ @ - - - - - - - - - @ @ @ - - - - - - - @ - - - - - - - @ @ @ @ - @ - - - - - - - - - - - - - - - -|
|- - @ @ - - - - - - - - - - - - - - - - - - - - - @ @ @ - - @ @ @ @ - - @ - - @ @ @ @ @ - - - - - @ @ @ @ @ @ - - - - - - - - - @ - - - - - - - - - - - - - - - - @ - @ - - - - - - - - - - - - - - - -|
|- - @ @ - - @ @ @ - - - - - - - - - @ @ @ - - - - - - - - @ @ @ @ - - - - - - @ @ @ - - - - - - - - - @ @ @ @ - - - - - - - - - @ - - - - - - - @ - - - - - - - - - - - - - - - - - - - - - - - - - - -|
|- - - - - - - - - - - - - - - - - - - - - - - - - - - @ @ @ - - - - - - - - - - - - - - - - - - @ - @ @ - @ - - - - - - @ - - - @ - - - - - - - @ @ @ - - - - @ @ - - - - - - - - - - - - - - - - - - -|
|- - - - - - - - - - - - - - - - - - - - - - - - - - - - - - - - - - - - - - - - - - - - - - - - @ - @ @ - @ - - - - - - @ - - - @ @ - - - - @ @ @ @ - - - - - @ @ - @ @ @ - - - - - - - - - - - - @ @ @|
|- - - - - - - - - - - - - - - - - - - - - - - - - - - @ - - - - - - - - - - - - - @ - - - - - - @ - - - - - - - - @ @ - @ - - - @ @ - - - - @ @ @ @ - - - - - - - - - - - - @ @ - - - @ - - - - - - - -|
|- - - - - - - - - @ @ @ - - - - - - - - - - @ - - - - @ - - - - - - - - - - - - - @ - - - @ @ - - - - - - - - - @ @ @ - - - - - - - - - - - - - - - - - - - - - - - @ @ - - @ @ - - - @ - - - @ @ @ - -|
|- - @ - - - - - - - - - - - - - @ @ @ - - - @ - - - - @ - - - - - - - - - - @ @ @ @ - - - @ @ - - - @ - - - @ @ @ - - - - - - - - - - - - @ @ @ - - - - - - - @ @ @ @ @ - - - - - - - @ - - - - - - - -|
|- @ @ - - - - - - - - @ @ @ - - - - @ @ - - @ - - - - - - - - - - - - - - - - - - @ - - - - - - - - @ - - - - - - - - - - - - - - - @ @ - - - - - - - - - - - - - - - - - - - - - - - - - - - - - - - -|
|- @ @ - - - - - - - - @ @ - - - - - @ @ - @ @ - - - - - - - - - - - @ @ - - - - - - - - - - - - - - @ @ @ @ - - @ @ @ - - - - - - - @ @ - - - - - - @ - - - - - - - - - - - - - - - - - - - - - - - - -|
|- @ - - - - - - - - - @ @ - @ @ - - @ - - @ @ - - - - - - - - - - - @ @ @ - - - - - - - - - - - - - - - - @ @ @ @ - - - - - - - - - @ @ - - - - - - @ - - - - - - - - - - - - - - - - - - - - - - - - -|
|- - - - - - - - - - - - - - @ @ - - @ - - - - - - - - - - - - - - - - - @ - - - - @ @ - - - - - - - - @ @ @ - - - - - - - - - - - - @ @ - - - - - - @ - - - - - - - - - - - - - - - - - - - - - - - - -|
