20 6
|- - - @ - - - - - - - - - - - - - - - -|
|- - - @ - - - - - - - - - - - - - - - -|
|- @ @ @ - - @ @ @ - - - - - - - - - - -|
|- - - - - - - - - - - - - - - - - - - -|
|- - - - - - - - - - - - - - - - - - - -|
|- - - - - - - - - - - - - - - - - @ @ @|
