50 50
|- - - - - - - - - - - - - - - - - - - - - - - - - - - - - - - - - - - - - - - - - - - - - - - - - -|
|- - - - - - - - - - - - - - - - - - - - - - - - - - - - - - - - - - - - - - - - - - - - - - - - - -|
|- - @ - - - - - - - - - - - - - - - - - - - - - - - - - - - - - - - @ - - - - - - - - - - - - - - -|
|- - @ - - - - - - - - - - - - - - - - - - - - - - - - - - - - - - - @ - - - - - - - - - @ - - - - -|
|- - @ - - @ @ - - - - - - - - - - - - - - - - - - - - - - @ @ - - - @ - - - - - - - - - @ - - - - -|
|- - - - - @ @ - - - - - - - - - - - - - - - - - - - - - - @ @ - - - - - - - - - - - - - @ - - - - -|
|- - - - - - - - - - - - - - - - - - - - - - - - - - - - - - - - - - - - - - - - - - - - - - - - - -|
|- - - - - - - - - - - - - - - - - - - - - - - - - - - - - - - - - - - - - - - - - - - - - - - - - -|
|- - - - - - - - - - - - - - - - - - - - - - - - - - - - - - - - - - - - - - - - - - - - - - - - - -|
|- - - - - - - - - - - - - - - - - - - - - - - - - - - - - - - - - - - - - - - - - @ @ @ @ @ - - - -|
|- - - - - - - - - - - - - - - - - - - - - - - - - - - - - - - - - - - - - - - - - @ @ - - - - - - -|
|@ @ - - - - - - - - - - - - - - - - - - - - - - - - - - - - - - - - - - - - - - - - - - - - - - - -|
|- - - - - - - - - - - - - - - - - - - - - - - - - - - - - - - - - - - - - - - - - @ @ - - - - - - -|
|- - - - - - - - - - - - - - - - - - - - - - - - - - - - - - - - - - - - - - - - - @ @ - - - - - - -|
|- - - - - - - - - - - - - - - - - - - - - - - - - - - @ @ @ - - - @ - - - - - - - - - - - - - - - -|
|- - - - - - - - - - - - - - - - - - - - @ @ - - - - - - - - - - - @ - - - - - - - - - - - - - - - -|
|- - @ @ - - - - - - - - - - - - - - - - @ @ - - - - - - - - - - - @ - - - - - - - - - - - - - - - -|
|- - @ @ - - - - - - - - - - - - - - - - - - - - - - - - - - - - - - - - - - - - - - - - - - - - - -|
|- - - - - - - - - - - - - - - - - - - @ @ @ @ - - - - - - - - - - - - - - - - - - - - - @ @ @ - - @|
|@ @ - - - - - - - - - - - - - - - - - - - - @ - @ - - - - - - - - - - - - - - - - - - - - - - - - @|
|- - - - - - - - - - - - - - - - - - - - - - @ - @ - - - - - - - - - - - - - - - - - - - - - - - - -|
|- - - - - - - - - - - - - - - - - @ @ @ - - - - @ - - - - - - - - - - - - - - - - - - - - - - - - -|
|- - - - - - - - @ - - - - - - - - - - - - - - - - - - - - - - - - - - - - - - - - - - - - - - - - -|
|- - - - - - - - @ - - - - - - - - - - - - - - - - - - - @ - - - - - - - - - - - - - - - - - - - - -|
|- - - - - - - - @ - - - - - - - - - - - - - - - - - - - @ - - - - - - - - - - - - - - - - - - - @ @|
|- - - - - - - - - - - - - - - - - - - - - - - - - - - - @ - - - - - - - - - - - - - - - - - - - @ @|
|- - - - - - - - - - - - - - - - - - - - - - - - - - - - - - - - - - - - - - - - - - - - - @ @ - - -|
|- - - - - - - - - - - - - - - - - - - - - - - - - - - - - - - - - - - - - - - - - - - - - @ @ - - -|
|- - - - - - - - - - - @ - - - - - - - - - - - - - - - - - - - - - - - - - - - - - - - - - - - - - @|
|- - - - - - - - - - - @ - - - - - - - - - - - - - - - - - - - - - - - - - - - - - - - - - @ @ @ - @|
|- - - - - - - - - - - @ - - - - - - - - - - @ - - - - - - - - - - - - - - - @ @ @ - - - - - - - - @|
|- - - - - - - - - - - - - - - - - - - - - - @ - - - - - - - - - - - - - - - - - - - - - - - - - - -|
|- - - - - - - - - - - - - - - - - - - - - - @ - - - - - - - - - - - - - - - - - - - - - - - - - - -|
|- - - - - - - - - - - - - - - - - - - - - - - - - - - - - - - - - - @ @ - - - - - - - - - - - - - -|
|- - - - - - - - - - - - - - - - - - - - - - - - - - - - - - - - - - @ @ - - - - - - - - - - - - - -|
|- - - - - - - - - - - - - - - - - - - - - - - - - - - - - - - - - - - @ @ @ - - - - - - - - - - - -|
|- - - - - - - - - - - - - - - - - - - - @ @ - - - - - - - - - - - - - - - - - - - - @ @ - - - - - -|
|- - - - - - - - - - - - - - - - - - - - @ @ - - - - - - - - - - - @ @ - - - - - - - @ @ - - - - - -|
|- - - - - - - - - - - - - - - - - - - - - - - - - - - - - - - - - @ @ - - - - - - - - - - - - - - -|
|- - - - - - - - - - - - @ @ - - - - - - - - - - - - - - - - - - - - - - - - - - - - - - - - @ @ - -|
|- - - - - - - - - - - - @ @ - - - - - - - - - - - - - - - - - - - - - - - - - - - - - - - - @ @ - -|
|- - - @ @ @ - - - - - - - - - - - - - - - - - - - - - - - - - - - - - - - - - - - - - - - - - - - -|
|- - - - - - - - - - - - - - @ - @ - - - - - - - - - - - - - - - - - - - - - - - - - - - - - - - - -|
|- - - - - - - - - - - - - - @ - @ - - - - - - - - - - - - - - - - - - - - - - - - - - - - - - - - -|
|- - - - - - - - - - - @ - - @ - @ - - - - - - - - - - - - - - - - - @ @ - - - - - - - - - - - - - -|
|- - - - - - - - - - - @ - - - - - - - - - - - - - - - - - - - - - - @ @ - - - - - - - - - - - - - -|
|- - @ @ @ - - - - - - @ - - - - - - - - - - - - - - - - - - - - - - - - - - - - - - - - - - @ - @ -|
|- - - - - - - - - - - - - - - - - - - - - - - - - - - - - - - - - - - @ @ @ - - - - - - - - @ - @ -|
|- - - - - - - - - - - - - - - - - - - - - - - - - - - - - - - - - - - - - - - - - - - - - - @ - @ -|
|- - - - - - - - - - - - - - - - - - - - - - - - @ @ - - - - - - - - - - - - - - - - - - - - - - - -|
