30 30
|- - - - - - - - - - - - - - - - - - - - - - - - - @ - - @ -|
|- - - - - - - - - - - - - - - - - - - - - - - - - @ - - @ -|
|- - - - - - - - - - - - - - - - - - - - - - - - @ @ - - @ -|
|- - - - - - - - - - - - - - - - - - - - - - - - @ @ - - - -|
|- - - - - - - - - - - - - - - - - - - - - - - - - - - - - -|
|- - - - - - - - - - - - - - - - - - - - - - - - - - - - - -|
|- - - - - - - - - - - - - - - - @ @ - - - - @ @ - - - - - -|
|- - - - - - - - - - - - - - - - @ @ - - - - @ @ - - - - - -|
|- - - - - - - - - - - - - - - - - - - - - - - - - - - - - -|
|- - - - - - - - - - - @ @ @ - @ - @ @ @ - - - - - - - - - -|
|- - - - - - - - - - - @ - - - @ - - - - - - @ @ @ - - - - -|
|- - - - - - - - - - - @ - - - @ - - - - - - - - - - - - - -|
|- - - - - - - - - - - - - - - - - - - - - - - - - - - - - -|
|- - - - - - - - - - @ - - - - - - - - - - - - - - - - - - -|
|- - - - - - - - - - @ - - - - - - - - - - - - - - - - - - -|
|- - - - - - - - - - @ - - - - - - - - - - - - - - - - - - -|
|- - - - - - - - - - - - - - - - - - - - - - - - - @ @ - - -|
|- - - - - - - - - - - - - - - - - - - - - - - - - @ @ - - -|
|- - - - - - - - - - - - - - - - - - - - - - - - - - - - - -|
|- - - - - - - - - - - - - - - - - @ @ @ - @ @ - - - - - - -|
|- - - - - - - - - - - - - - - - - - - - - @ @ - - - - - - -|
|- - - - - - - - - - - - - - - - - - - - - - - - - - - - - -|
|- - - - - - - - - - - - - - - - - - - - @ @ - - - - - - - -|
|- - - - - - - - - - - - - - - - - - - - @ @ - - - - - - - -|
|- - - - - - - - - - - - - - - - - - - - - - - - - - - - - -|
|- - - - - - - - - - - - - - - - - - - - - - - - - - - - - -|
|- - - - - - - - - - - @ @ - - - - - - - - - - - @ - - - - -|
|- - - - - - - - - - - @ @ - - - - - - - - - - - @ - - - - -|
|- - - - - - - - - - - - - - - - - - - - - - - - @ - - - - -|
|- - @ @ - - - - - - - - - - - - - - - - - - - - - - - - - -|
