20 20
|- - - - - - - - - - - - - - - @ - - @ @|
|- - - - - - - - - - - - - - - @ - @ @ @|
|- - - - - - - - - @ - - - - - - - @ @ -|
|- - - - @ @ @ - - @ - - - - - - - @ @ -|
|- - - - - - @ - - @ - - - - - - @ @ @ -|
|- - - - - - @ - - - - @ @ @ @ @ @ - - -|
|- - - - - - @ - @ @ - - - - - - - - - -|
|- - - - - - - - @ @ - @ - - - - - - - -|
|- - - - - - - - - - - @ - - - - - - - -|
|- - - - - - @ @ - - @ @ - - - - - - - -|
|- - - - - - @ @ - - @ - - - - - - - - @|
|- - - - - - @ @ @ - @ - - - - - - - - @|
|- - - - - @ @ - - - - - - - - - - - - -|
|- - - - - @ - - - - - - - - - - - - - -|
|- - - - - @ @ - - - - @ @ - - - - - - -|
|- - - - @ @ @ - - - - @ @ - - - - - @ -|
|@ @ - - @ @ @ - - - - - - - - - - - @ -|
|@ @ - - - - @ - - - - - - - - - - @ @ -|
|- - - - - - @ - - - - @ - - - - - @ @ @|
|- - - - - - - - - @ @ @ - - @ @ @ @ - @|
