50 50
|- - - - - - - - @ @ - - - - - @ @ - - - - - - @ @ @ - - - - - - @ @ @ @ @ - - - - - - - - - - - - -|
|- @ @ - - - - - @ @ - - - - - @ @ - @ @ @ - - - - - - - - - - - @ @ - @ - - - - - @ @ @ - - - - - -|
|- @ @ @ - - - - - - - - - - - @ @ - @ @ - - - - - @ @ - - - - - - - - @ - - - - - - - - - - - - - -|
|- - @ @ @ @ - @ @ @ - - - - - - - - - - - - - @ @ @ @ - - - - - - - - - - - - - - - - - - - - - - -|
|- - @ - - - - - - - - - - - - - - - - - - - - @ @ @ - - - - - - - - - - - - - @ @ @ - - - - - - - -|
|- - @ - - - - - - - - - - - - - - - - @ @ - - @ - - - - - - - - - - - - - @ @ @ - @ @ - - - - - - -|
|- - @ - - - - - - @ @ @ - @ @ - - - - @ @ - - - - - - - - - - - - - - - - - - - - @ @ - - - - - - -|
|- @ @ - - - - - - - - - - @ @ @ - - - - - - - - @ - - - - - - - @ @ - - - - - - - - - - - - - - - -|
|- @ @ - - - - - - - - - - - @ @ - - - - - - @ @ @ - - - - - - - @ @ - - - - - - - - - - - - - - - -|
|- - - - - - - - - - - - - - - - - - - - - - - - @ @ - @ @ - - - - - - - - - - - - - @ @ - - - - - -|
|- - - - - - @ - - - - - - - - - - - - - - - - @ @ @ - @ @ - - - - - - - - - - - @ - @ @ - - - - - -|
|- - - - - - @ - - - - - - - - - - - @ @ @ @ @ @ @ @ @ @ @ - - - - - - - - - - - @ - - - - - - - - -|
|- - - - - - @ - - - @ @ - - - - - - - - - @ @ @ - - - @ @ - - - @ @ @ @ - - - - @ - @ @ @ @ - - - @|
|@ @ - @ - - - - - - @ @ - - - - - - - - - - - - - - - @ @ - - - - - - @ @ @ @ - - - @ @ @ - - @ @ @|
|- - - @ - - - - - - - - - - - - @ - - - - - - - @ - - @ @ - - - - - - @ - - - - - - @ @ - - - @ @ @|
|- - - @ - - - - - - - - - - - - @ - - @ @ @ - - @ - - - - - - - - - - @ @ - - - - @ @ @ - - @ @ - -|
|- - - @ @ @ @ - - - - - - - - - @ - - - - - - - @ - - - - - - - - - - - @ @ @ - - - - @ - - @ @ - -|
|- - - - - - - - - - - - - - - - - - - - - - - - - - - - - - - - - - - - @ @ @ - - - - - - - - @ @ -|
|- - - - - - - @ - - - - - - - - - - - - - @ @ @ @ @ @ - - - - - - - - - - - @ @ - - - - @ @ @ @ @ -|
|- - - @ - - - @ @ @ @ - - @ @ - - - - - - - - - - - @ @ @ @ @ @ - - - - - @ @ @ - - - - - - - @ @ -|
|- - - @ - - - @ - - - - - @ @ - - - @ @ - - - - - - - - - - - - - - - @ @ @ - - - - - - - - - @ @ -|
|- - @ @ - - - - - - - - - - - - - - @ @ - - - - @ - - - - - - - - - - @ @ - - - - - - - @ @ - - - -|
|- - @ @ - - - - - @ - - - - - - - - - - - - - - @ - - - - - - - - - - - - - - - - - - - @ @ - - - -|
|- - - - - - - - - @ - - - @ - - - @ @ @ - - - - @ - - - @ - - - - - - - - - - - - - - - - - - - - -|
|- @ @ - - - - - @ @ - - - @ - - - - @ - - - - - - - - - @ - - - @ - - - - - - - - - - - - @ @ - - -|
|- @ @ - - - - - @ @ - - - @ - - - - @ @ @ @ - - - - - - @ - @ @ @ - - - - - - - - - @ @ @ @ @ - - -|
|- - - - - - - - - - - - - @ @ @ @ - @ - - - - @ - - - - - - - - @ - @ - - - - - @ @ @ - - - - - - -|
|@ @ - - - - - - - - - - - - - - - - - - - - - @ - @ - - - - - - - - @ - - - - - @ @ - - - - - - - -|
|- - - - - - - - - - - - - - - - - - - - - - - @ - @ - - - - - - - - @ - - - - - - - - - - - - - - -|
|- - - @ @ @ - - - - - - - - - - - - - - - - - - - @ - - - - - - - - - - - - - - - - - - @ @ @ - - -|
|- - - - @ - - - - @ @ @ - - - - - - @ @ @ - - - - - - - - - - - - - - - - - - - @ - - - - - - - - -|
|- - - - @ - - @ @ @ @ @ - - - - @ @ @ - - - - - - - - - - - - - - - - - - @ @ - @ - - - - - - - - -|
|- - - - @ - @ @ @ - - - - - - - @ @ @ - - @ @ @ - - - - - - - - - @ @ - - @ @ @ @ - - - - - - - - -|
|- - - - @ @ @ - - - - - - - - - - - - - @ @ @ - - - - - - - - - - @ @ - - - @ @ - - - - - - - - - -|
|- - - - - - - - - - - - - - - - @ @ @ - - - - - - - - - - - - - - - - - - - @ @ @ - - - - @ - - - -|
|- - - - - @ @ @ - - - - - - - - - - @ - - - - - - - - @ @ @ @ @ - - - - - - - - @ @ @ - - @ - - - -|
|- - - - - - - - - - - - - - - - @ @ @ - - - - - - - - @ @ - - - - - @ @ - - - - - - - - - @ - - - -|
|- - - - @ @ @ - - @ - - - - @ @ @ @ @ - - - - - - - - - - - @ @ @ - @ @ - - - - - - - - - - - - - -|
|- - - - - - @ - - @ @ @ - - @ @ @ @ - - @ @ @ - - @ - - - - - - - - - - - - - - - - - - - - - - - -|
|@ @ - - - - @ - - @ @ @ - - - - - - - - - @ @ - - @ @ - - - @ @ @ @ @ @ - - - - - - - - - - - - - -|
|@ @ - - - - @ @ - - @ - - - - - - - - - - @ @ - - @ @ - - - - - - - - - - - - - - - - - - - - - - -|
|- @ - - - - - @ @ @ @ - - - - - - - - - - - - - - - @ @ - - - - - - - - @ - - - - - - @ @ @ - @ - -|
|- - - - - - - - - - @ - - - - - - - - - - - - @ @ - - @ @ @ @ @ - - - @ @ - - - - @ @ @ - @ @ @ - -|
|- @ - - @ @ - - - - - - - - - - - @ @ - - @ @ @ @ - - @ - - @ @ - @ - @ @ @ - - - - - - - @ @ @ - -|
|- @ @ @ @ @ - - - - - - - - - @ - @ @ - - @ @ - @ - - - - - - - - @ - - - @ @ - - - - - - @ @ - - -|
|- @ - - - - - - - - - - @ @ @ @ - - - - - - - - @ - - - - - - @ @ @ - - @ @ @ - - - - - - - - - - -|
|- - - - - - - - - - - - - - - @ - - - - - - - - - - - - - - - @ @ - - - - - - - - - - - - - - - - -|
|- - - - - - - - - - @ - - - - - - - - - - - - - - - - @ @ @ - - - - - - - - - - - - - @ @ - - - - @|
|- - - - - - - - - - @ - - - - - - - - - - - - - - - - - @ - - - - - - - - - - - - - - @ @ - - - - @|
|- - - - - - - - - - @ - - - - - - - - - - - - - - - - - @ - - - - - - - - - - - - - - - - - @ @ - -|
