30 30
|- - - - - - - - - - @ @ @ - - - - @ @ - - - @ @ @ - @ @ @ @|
|@ @ @ - - - @ - @ @ @ @ @ @ @ @ - @ @ - - - - @ - - - - @ @|
|@ @ @ - - - @ - - - - - - - - @ - - - - - - - @ - - @ @ @ @|
|- @ @ @ - @ @ - - - - - - - - @ - - - - @ @ @ @ - - @ @ - -|
|- - @ @ @ @ - - - - - - - - - @ - - @ @ @ @ - - - - @ - - -|
|@ @ @ - @ - - - - - - - @ - - - - - - - - @ @ - - - - - - -|
|- @ - - @ - - - - - - - @ - - - - - - - - @ @ @ - - - - @ -|
|- @ - - @ @ @ - - - - - @ - - - - - @ @ @ @ - @ @ @ - - @ -|
|- - - - - @ @ - - - @ @ @ - - - - - - @ @ @ - - - @ @ @ @ -|
|- @ - - - - - - - @ @ @ @ @ - - - - - @ - @ - - @ @ @ @ - -|
|- @ @ @ @ - @ @ @ @ @ - @ @ - - - - - @ @ @ - - - - @ @ - -|
|- @ - - - - - - - - - - @ @ - - - - - @ @ @ - @ - - - @ - -|
|- - - - - - - - - - - @ @ - - - - - @ @ @ @ @ @ - - @ @ @ @|
|- - - @ @ @ - - @ @ @ @ @ @ @ - - - @ - - @ - @ - - @ @ - -|
|- - - @ @ @ - - - @ @ @ - @ @ - - - @ - - @ - - - - - - - -|
|- - @ @ - - - - @ @ - @ @ @ @ @ @ - @ - - @ - - - - - - - @|
|- @ @ @ - - - - @ @ - - @ @ @ @ @ - - - - - - - - - - - - @|
|- @ @ @ @ @ @ @ @ - - - - - @ @ @ @ @ - @ @ - - - - - @ @ @|
|- - @ @ @ @ - - - - - - - @ @ @ - @ @ - @ @ - @ @ - - - - -|
|- - - - - - - - - @ @ - - - - - - @ @ - - - - @ @ - - - - -|
|- - - - - - - - - @ @ - - - - - - - - - - - - - - - - - - -|
|- - - - @ @ @ - @ @ - - @ - @ @ @ - - - - @ - - - - - - @ @|
|- @ @ @ @ - @ @ @ @ @ @ @ - - - - - - - - @ - @ @ @ @ @ @ -|
|- - - - - - - @ @ @ - @ @ @ @ @ - - @ @ @ @ - - - - - - - -|
|- - - - - @ @ @ @ - - - - - - @ @ @ @ @ @ - - - @ @ @ @ - -|
|- - - - - @ @ @ @ @ - - - - - - @ @ @ @ - - - - - @ @ @ - @|
|- - - - - - @ @ - @ - - - - @ @ @ @ @ @ - - @ @ - @ - @ @ @|
|- - - - - @ @ - - @ @ - - - - - - - - @ - - @ @ - @ - - @ @|
|@ @ - - - @ @ - - @ @ - - - - @ @ - - - - - @ - - - - - @ @|
|- - - - - - - - - - - - - - - @ @ - - - @ @ @ - - - - - @ @|
